old_trans;eng_word;new_trans
gardens - гарденс; en - гэрденс
niero - ниеро; en - ниро
d'aydie - даидие; en - дейдай
frabosk - фрабоск; en - фрейбоск
lermont - лермонт; en - лермонт
sensitive - сенситиве; en - сенситив
sfoglia - сфоглиа; en - сфоглиа
llopart - ллопарт; en - ллопэрт
gaffeliere - гаффелиере; en - гэффилир
messori - мессори; ita - мессори
grandma - грандма; en - грэндма
selosse - селоссе; ita - селоссе
domaine armand - домаине арманд; en - домаин армэнд
staropramen - старопрамен; en - стейропреймен
desir - десир; en - десер
rouge du chateau - роуге ду чатеау; fra - руж ду шато
alimentari - алиментари; en - алиментейри
lea - леа; en - ли
monbousquet - монбоусквет; fra - монбусквет
carillon de - cариллон де; fra - кариллон де
bellingham insignia - беллингхам инсигниа; en - беллингхэм инсайгниа
pasionado - пасионадо; en - пейзионейдо
anna lafarg - анна лафарг; en - анна лейфэрг
plum - плум; en - плам
membrillo - мембрилло; en - мембрилло
grizzly - гриззли; en - гриззли
cucumis - cуcумис; en - кьюкьюмис
angel - ангел; en - анджел
chantovent - чантовент; en - чэнтовент
shuzojo - шузоджо; en - шьюзоджо
valescure vignobles - валесcуре вигноблес; fra - валескур вигноблес
create - cреате; en - крит
legend of - легенд оф; en - ледженд оф
symphonia bee - симфониа бее; en - симфониа бе
vernoilaise - верноилаисе; en - верноилаиз
avecmoi - авеcмои; en - авекмои
l'atelier - лателиер; en - лейтилир
f.x - ф.кс; en - ф.кс
schrodel - шродел; ger - шродел
ott* - отт; en - отт
chateau clerc - чатеау cлерc; fra - шато клерк
guru - гуру; ita - гуру
grand-puy-lacoste - гранд-пуи-лаcосте; en - грэнд-пуи-лейкост
moeka - моека; en - моека
elis - элис; en - элис
casale - cасале; ita - касале
corine - cорине; ita - корине
gym pasta young - гим паста йоунг; en - джим пэста юнг
chateau la - чатеау ла; fra - шато ла
mouline - моулине; fra - мулин
domaine la taille - домаине ла таилле; ita - домаине ла таилле
penotti - пенотти; ita - пенотти
vine - вине; ita - вине
chodovar - чодовар; en - чодовэр
the scottish - те сcоттиш; en - зе скоттиш
roquebrun - роквебрун; fra - роквебрун
felluga - феллуга; ita - феллуга
chamore - чаморе; en - чеймор
dopdrops - допдропс; en - допдропс
honey - хоней; en - хони
sunsmile - сунсмиле; en - сансмил
heerengracht - хееренграчт; en - хиренгрэчт
brushes - брушес; en - брашес
kochstar - кочстар; ger - кохстар
robert - роберт; en - роберт
d'arques - дарквес; fra - дарквес
feast - феаст; en - фист
chefs - чефс; en - чефс
kwak - квак; en - квэк
qegg - кегг; en - кегг
provencal - провенcал; en - провенкэл
schiefer - шиефер; ger - шифер
quinta - квинта; en - квинта
mela - мела; ita - мела
purdey's - пурдеис; en - пердеис
black label - блак лабел; en - блэк лейбел
beatrix - беатрикс; en - битрикс
pick - пик; en - пик
goods - гоодс; en - гудс
d'estournel - дестоурнел; fra - дестурнел
titbit - титбит; en - титбит
pellehaut harmonie de - пеллехаут хармоние де; fra - пеллехаут хармони де
baudry - баудри; en - боадри
ottosoldi - оттосолди; ita - оттосолди
dab - даб; en - дэб
globster - глобстер; ger - глобштер
arm - арм; en - арм
biopractika - биопраcтика; en - биопрэктика
003 - 003; en - 003
auchentoshan - аучентошан; ger - аухентошан
cefiro - cефиро; ita - чефиро
bruichladdich - бруичладдич; ger - бруихладдих
the chemical - те чемиcал; en - зе чимикэл
hollender - холлендер; en - холлендер
kulmbacher - кулмбачер; en - калмбэчер
interlock - интерлок; en - интерлок
altero - алтеро; en - алтиро
hollandia - холландиа; ita - холландиа
veroni - верони; ita - верони
coleccion - cолеccион; en - колексион
uni - уни; en - юни
osteria - остериа; en - остириа
spiegelau - спиегелау; en - спиджелоу
primo - примо; en - примо
red - ред; en - ред
bon - бон; en - бон
pichon longueville - пичон лонгуевилле; en - пичон лонгьювилл
domaine de pellehaut - домаине де пеллехаут; fra - домаин де пеллехаут
blanch de - бланч де; fra - бланш де
cardhu - cардху; en - кэрдху
grill - грилл; en - грилл
hans - ханс; en - хэнс
dairy - даири; en - дэери
wai - ваи; en - ваи
il gusto - ил густо; en - ил гасто
romano - романо; ita - романо
gruntaler - грунталер; en - грантейлер
pril - прил; en - прил
chateau pape - чатеау папе; fra - шато пап
danish - даниш; en - дейниш
acetaia - аcетаиа; fra - акетаиа
silko - силко; en - силко
tarlant - тарлант; en - тэрлэнт
may de - май де; fra - маи де
heineken - хеинекен; en - хеиникен
riecine - риеcине; en - рисин
d.d. - д.д; en - д.д
edradour - эдрадоур; fra - эдрадур
scottish fine soaps - сcоттиш фине соапс; en - скоттиш фин соапс
gemischter - гемиштер; ger - гемиштер
shelim - шелим; en - шилим
arla - арла; en - арла
atkins & - аткинс &; en - аткинс &
porcelaine czech - порcелаине cзеч; ger - поркелаине кзех
pontet - понтет; en - понтет
horny - хорни; en - хорни
nocciolata - ноccиолата; ita - ноччиолата
carmani - cармани; en - кэрмейни
snackars - снакарс; en - снэкэрс
frozen - фрозен; ger - фрозен
vinhos - винхос; en - винхос
xenta - ксента; en - ксента
liebe - лиебе; en - либ
cheese - чеесе; en - чиз
stay - стай; en - стей
chikao - чикао; en - чикао
damm - дамм; en - дэмм
domaine antonin - домаине антонин; en - домаин антонин
lab. - лаб; en - лэб
abuelo - абуело; en - абьюло
chateau pavie - чатеау павие; fra - шато пави
ladelle - ладелле; ita - ладелле
lamour - ламоур; fra - ламур
warsteiner - варстеинер; ger - варштейнер
qia - киа; en - киа
pasticcere - пастиccере; ita - пастиччере
bodegas palacios - бодегас палаcиос; en - бодигэс пейлейсиос
cartron - cартрон; en - кэртрон
banana - банана; ita - банана
nordqvist - нордквист; en - нордквист
bouchaud le - боучауд ле; fra - бушауд ле
citran - cитран; en - ситрэн
sana - сана; ita - сана
crunchy - cрунчи; en - кранчи
williams - виллиамс; en - виллиамс
riverlore - риверлоре; en - риверлор
manuoki - мануоки; en - мейнуоки
jean-marc brocard - джеан-марc броcард; en - джин-мэрк брокэрд
tart - тарт; en - тэрт
han - хан; en - хэн
palm - палм; en - пэлм
d'orfeuilles - дорфеуиллес; fra - дорфеуиллес
softymo mineral - софтимо минерал; en - софтаймо минирэл
distillery - дистиллери; en - дистиллири
simonini - симонини; ita - симонини
honke - хонке; en - хонк
hakushika tatsuuma - хакушика тацуума; en - хейкашика тэтсуума
wagon - вагон; en - вейгон
ballarini - балларини; ita - балларини
lequin-colin - леквин-cолин; en - ликвин-колин
chateau tour des - чатеау тоур дес; fra - шато тур дес
landron - ландрон; en - лэндрон
france - франcе; fra - франс
juliette - джулиетте; ita - жулиетте
manuka - манука; ita - манука
nature s - натуре с; ita - натуре с
choya - чоя; en - чоя
quinta do - квинта до; ita - квинта до
trixie - триксие; en - триксай
allende - алленде; ita - алленде
romans - романс; en - ромэнс
gusto della - густо делла; ita - густо делла
ardi - арди; en - арди
harmonie - хармоние; en - хэрмонай
culemborg - cулемборг; en - кьюлемборг
multiplus - мултиплус; en - малтиплас
riegele - риегеле; en - риджил
cauhape - cаухапе; en - коьюхейп
l'angelus - лангелус; en - лэнджилас
folke - фолке; en - фолк
glenglassaugh - гленглассаугх; en - гленглэссоа
francaise - франcаисе; en - фрэнкаиз
delray beach - делрай беач; en - делрей бич
thomas foods - томас фоодс; en - сомэс фудс
mancin - манcин; en - мэнсин
regal - регал; en - ригэл
labo - лабо; ita - лабо
a'pieu - апиеу; fra - апиеу
bellingham - беллингхам; en - беллингхэм
renu - рену; ita - рену
ode - оде; en - од
graham - грахам; en - грейхэм
veltins - велтинс; en - велтинс
nepenthe - непенте; en - нипенз
silampos - силампос; en - силэмпос
little - литтле; en - литтл
granto - гранто; en - грэнто
vacu - ваcу; ita - ваку
nobby - нобби; en - нобби
sinnack - синнак; en - синнэк
diablo - диабло; en - диабло
fad - фад; en - фэд
kandylas - кандилас; en - кэндайлэс
cesar - cесар; en - сизэр
j7 - дж7; en - дж7
long - лонг; en - лонг
francaise de - франcаисе де; fra - франкаиз де
black angus - - блак ангус; en - блэк ангас
piano - пиано; en - пиано
d'alibert - далиберт; en - дейлиберт
tour des - тоур дес; fra - тур дес
zipfer - зипфер; en - зипфер
branaire-ducru - бранаире-дуcру; en - брейнэере-дакру
fernet - фернет; en - фернет
halal - халал; en - хейлэл
salzburg - салзбург; ger - залцбург
sunny - сунни; en - санни
farmstay - фармстай; en - фэрмстей
toscana - тосcана; en - тоскейна
winkler - винклер; en - винклер
pedesclaux - педесcлаукс; fra - педесклаукс
smoca - смоcа; en - смока
vin - вин; en - вин
carillon - cариллон; en - кейриллон
jti co - джти cо; ita - жти ко
punica - пуниcа; ita - пуника
l'arlot - ларлот; en - лэрлот
matusalem - матусалем; en - мэтьюзейлем
rendez - рендез; en - рендез
nv - нв; en - нв
schleicher - шлеичер; ger - шлейхер
la tuilerie - ла туилерие; fra - ла туилери
haut bages - хаут багес; en - хоат бэджес
fujiya - фуджия; en - фьюджия
vignoble - вигнобле; en - вайгнобл
bodegas hermanos - бодегас херманос; en - бодигэс хермейнос
capo di - cапо ди; ita - капо ди
etude - этуде; en - этьюд
flamigni - фламигни; en - флэмайгни
nutrition - нутритион; en - натришен
artsakh - арцакх; en - артсэкх
bodegas y vinedos - бодегас и винедос; en - бодигэс и винидос
simplyrow - симплиров; en - симплироу
pet - пет; en - пет
men expert skin - мен эксперт скин; en - мен эксперт скин
naturaverde - натураверде; en - нэтерейверд
miolla - миолла; ita - миолла
domeine - домеине; en - домеин
bio-max - био-макс; en - био-мэкс
concentrate - cонcентрате; en - консентрейт
name - наме; ita - наме
weil - веил; en - веил
anwilka - анвилка; en - анвилка
apagard - апагард; en - апейгэрд
atlantico - атлантиcо; en - атлэнтико
botanical - ботаниcал; en - ботейникэл
courvoisier - cоурвоисиер; fra - курвуазиер
pads - падс; en - пэдс
voh - вох; en - вох
naturprodukte - натурпродукте; en - нэтерпродакт
marquesa - марквеса; fra - марквеза
retreat - ретреат; en - ретрит
prieur-brunet - приеур-брунет; fra - приеур-брунет
shaker - шакер; en - шейкер
atkins - аткинс; en - аткинс
leiner - леинер; en - леинер
l'lle de - ллле де; fra - ллле де
grade - граде; en - грейд
fish - фиш; en - фиш
noire - ноире; en - ноая
d'issan - диссан; en - диссэн
les ormes - лес ормес; fra - ле ормес
botavikos - ботавикос; en - ботейвикос
stiegl - стиегл; en - стигл
chinaware - чинаваре; en - чиновор
spreewald - спреевалд; en - спреьюэлд
sucre - суcре; en - сакр
martell - мартелл; en - мэртелл
berio - берио; en - бирио
perrier-jouet - перриер-джоует; fra - перриер-жует
campos - cампос; en - кэмпос
johnny's chop - джохннис чоп; en - джохннис чоп
appetite - аппетите; ita - аппетите
o'hara's - охарас; en - охейрэс
belgian - белгиан; en - белджиан
pere et - пере эт; ita - пере эт
blanc - бланc; en - блэнк
beckmann - бекманн; en - бекмэнн
moutard - моутард; fra - мутард
issan - иссан; en - иссэн
petreet - петреет; en - петрит
chanoine - чаноине; en - чейноин
shanghai chikao - шангхаи чикао; en - шэнгхаи чикао
domeine la - домеине ла; fra - домеин ла
gravaillas - граваиллас; en - грейваиллэс
bonny - бонни; en - бонни
di san - ди сан; ita - ди сан
knappogue - кнаппогуе; ita - кнаппогью
adega cooperativa - адега cооператива; en - адига куперейтива
les jardins - лес джардинс; fra - ле жардинс
domaine amiot - домаине амиот; en - домаин амиот
lanessan - ланессан; en - лейнессэн
gi - ги; ita - джи
bozita - бозита; ita - бозита
all natural - алл натурал; en - ол нэтерэл
vodopivec - водопивеc; en - водопивек
rechtenbacher - речтенбачер; ger - рехтенбахер
gisele - гиселе; ita - джиселе
megami - мегами; ita - мегами
solaire - солаире; en - солэая
madia - мадиа; en - мейдиа
don - дон; en - дон
roberto - роберто; en - роберто
chacra - чаcра; en - чэкра
doyac - дояc; en - дояк
eesti - еести; en - исти
carne de - cарне де; fra - карн де
efes - эфес; en - эфес
poderi - подери; ita - подери
lord - лорд; en - лорд
jameson - джамесон; en - джеймизон
trawa - трава; en - трова
mj - мдж; en - мдж
chateau grand corbin - чатеау гранд cорбин; fra - шато гранд корбин
lactoferrin - лаcтоферрин; en - лэктоферрин
swirl - свирл; en - сверл
stor - стор; en - стор
hosten - хостен; en - хостен
square - скваре; en - сквар
steripan - стерипан; en - стирипэн
nakatomi - накатоми; ita - накатоми
italia in - италиа ин; en - итейлиа ин
reali - реали; en - рили
show - шов; en - шоу
grands houx - грандс хоукс; fra - грандс хо
nestogen - нестоген; en - нестоджен
europol - еуропол; fra - европол
bellegrave - беллеграве; ita - беллеграве
feedback - феедбак; en - фидбэк
goldfish - голдфиш; en - голдфиш
levrana - леврана; en - леврейна
razors - разорс; en - рейзорс
les hauts - лес хауц; fra - ле хаутс
fresca - фресcа; en - фреска
bodegas campos - бодегас cампос; en - бодигэс кэмпос
quickpack - квикпак; en - квикпэк
kahlua - кахлуа; en - кэхлуа
tero eco - теро эcо; ita - теро эко
lsa - лса; en - лса
de may de - де май де; fra - де маи де
mort - морт; en - морт
kose softymo - косе софтимо; ita - косе софтимо
comte de - cомте де; fra - комт де
barone - бароне; ita - бароне
aurel - аурел; en - аерел
laffitte-teston - лаффитте-тестон; ita - лаффитте-тестон
teacher's - теачерс; en - тичерс
czech - cзеч; ger - кзех
case basse di - cасе бассе ди; ita - касе бассе ди
lacapelle - лаcапелле; ita - лакапелле
sparina - спарина; en - спейрина
clos - cлос; en - клос
softymo - софтимо; en - софтаймо
magnien - магниен; en - мэгнин
vinedos - винедос; en - винидос
serre - серре; ita - серре
happy - хаппи; en - хэппи
michel - мичел; en - мичел
chateau cos - чатеау cос; fra - шато кос
4uze - 4узе; ita - 4узе
great - греат; en - грит
sichel - сичел; en - сичел
vineyard estate - винеярд эстате; en - виниярд эстейт
jean de - джеан де; fra - жеан де
laurenz - лауренз; ger - лауренц
cream - cреам; en - крим
perle - перле; en - перл
tai - таи; en - таи
kim - ким; en - ким
pomerols - померолс; en - помиролс
ola - ола; en - ола
taille - таилле; ita - таилле
leroy - лерой; en - лирои
viticultori - витиcултори; en - витикалтори
coco - cоcо; ita - коко
export - экспорт; en - экспорт
sainte-claire - саинте-cлаире; en - саинте-клэая
d'eugenie - деугение; en - дьюдженай
poderi aldo - подери алдо; ita - подери алдо
signature - сигнатуре; en - сайгнэтер
gym pasta - гим паста; en - джим пэста
zacapa - заcапа; ita - закапа
& the - & те; en - & зе
ruffoni - руффони; en - раффони
fit-fit - фит-фит; en - фит-фит
d'orignac - доригнаc; en - дорайгнэк
home of - хоме оф; ita - хоме оф
domaine thierry et - домаине тиерри эт; en - домаин зиерри эт
fiorella - фиорелла; ita - фиорелла
baron philippe - барон филиппе; en - бейрон филипп
malpighi - малпигхи; en - мэлпайгхи
bcl - бcл; en - бкл
pellehaut - пеллехаут; en - пеллехоат
adrenaline - адреналине; en - адренейлин
chin-su - чин-су; en - чин-су
all - алл; en - ол
domaine le - домаине ле; fra - домаин ле
dana - дана; ita - дана
les vignerons - лес вигнеронс; fra - ле вигнеронс
pinopasso - пинопассо; ita - пинопассо
xd design bobby - ксд десигн бобби; en - ксд дезайгн бобби
kaapse rooi oude - каапсе роои оуде; fra - каапс роуа уд
derma - дерма; en - дерма
ideshigyo - идешигио; en - идешиджио
farm - фарм; en - фэрм
chateau beau - чатеау беау; fra - шато бо
wine - вине; ita - вине
roses - росес; en - розес
crinan - cринан; en - кринэн
alghero - алгхеро; en - алгхиро
greenfield - греенфиелд; en - гринфилд
reales - реалес; fra - реалес
chandon - чандон; en - чэндон
noodles - ноодлес; fra - ноодлес
gordon's - гордонс; en - гордонс
celebrate - cелебрате; en - силебрейт
alpasion - алпасион; en - алпейзион
bonne - бонне; en - бонн
campanaro - cампанаро; en - кэмпейнейро
chai - чаи; en - чаи
pol-mak - пол-мак; en - пол-мэк
chateau le - чатеау ле; fra - шато ле
sensei la maison - сенсеи ла маисон; fra - сенсеи ла маизон
bio-oil - био-оил; en - био-оил
eunyul - еуниул; en - евнюл
georges - георгес; en - джирджес
australian - аустралиан; en - оастрейлиан
jigott - джиготт; en - джиготт
zooexpress - зооекспресс; fra - зооекспресс
zot - зот; en - зот
tsingtao - цингтао; en - тсингтао
umenishiki - уменишики; en - юминишики
valdueza - валдуеза; en - вэлдьюза
grand cru - гранд cру; en - грэнд кру
vinturi - винтури; en - винтери
du chateau - ду чатеау; fra - ду шато
david - давид; en - дейвид
west - вест; en - вест
suntory - сунтори; en - сантори
borie - борие; en - борай
nothing - нотинг; en - нозинг
weingut reichsgraf - веингут реичсграф; ger - вейнгут рейхсграф
tac - таc; en - тэк
visciano - висcиано; en - виссиано
potter - поттер; en - поттер
moro - моро; ita - моро
quantum - квантум; en - квантам
drambuie - драмбуие; fra - драмбуи
deep - дееп; en - дип
domaine bruno - домаине бруно; en - домаин брьюно
moremo - моремо; ita - моремо
pezzetti - пеззетти; ita - пеццетти
neil - неил; en - неил
cillit - cиллит; en - силлит
monasterio - монастерио; en - монэстирио
ora2 - ора2; en - орэ2
lemon - лемон; en - лимон
boulard - боулард; fra - булард
clair - cлаир; en - клэер
piron - пирон; en - перон
la porta - ла порта; fra - ла порта
fond - фонд; en - фонд
kozel - козел; en - козел
marinex - маринекс; en - мейринекс
cab prime - cаб приме; en - кэб прим
suduiraut - судуираут; en - сьюдаероат
brisson - бриссон; en - бриссон
dgj - дгдж; en - дгдж
pearl river - пеарл ривер; en - пирл ривер
ceretto - cеретто; ita - черетто
garzon-maldonado - гарзон-малдонадо; ger - гарзон-малдонадо
serristori - серристори; ita - серристори
baron philippe de - барон филиппе де; fra - барон филипп де
md - мд; en - мд
shanghai - шангхаи; en - шэнгхаи
eins zwei - еинс звеи; en - еинс звеи
brandi - бранди; en - брэнди
alldays - аллдаис; en - олдейс
soy - сой; en - сои
finest - финест; en - финест
grondard - грондард; en - грондэрд
ivv - ивв; en - ивв
haus - хаус; en - хоас
fass - фасс; en - фэсс
domaine les grands - домаине лес грандс; fra - домаин ле грандс
zecca - зеccа; ita - зецца
gemma - гемма; en - джемма
traquair - тракваир; fra - тракваир
clicquot - cлиcквот; en - кликквот
napla - напла; en - нэпла
teston - тестон; en - тестон
domaine hubert - домаине хуберт; en - домаин хьюберт
miraflores - мирафлорес; en - мерэфлорес
san giuliano - сан гиулиано; en - сэн джиулиано
minimax - минимакс; en - минимэкс
te - те; ita - те
spelta - спелта; en - спелта
l'eglis - леглис; en - леглис
catalan - cаталан; en - кейтейлэн
male - мале; ita - мале
gnarly - гнарли; en - гнэрли
ishihara - ишихара; en - ишихейра
mere - мере; ita - мере
thailand - таиланд; en - саилэнд
caliterra - cалитерра; ita - калитерра
pagar - пагар; en - пейгэр
bacardi - баcарди; en - бейкэрди
giusti - гиусти; en - джиусти
esprit de - эсприт де; fra - эсприт де
phelps - фелпс; en - фелпс
butter - буттер; en - баттер
cadillac - cадиллаc; en - кейдиллэк
naty - нати; en - нейти
dp - дп; en - дп
backerei - бакереи; en - бэкиреи
laville - лавилле; ita - лавилле
reichsgraf - реичсграф; ger - рейхсграф
peeps - пеепс; en - пипс
england - энгланд; en - инглэнд
ivv every - ивв эвери; en - ивв эвири
tai chinaware - таи чинаваре; en - таи чиновор
les hauts de - лес хауц де; fra - ле хаутс де
dillon - диллон; en - диллон
jetbottle - джетботтле; en - джетботтл
rocheyron - рочеирон; en - рочеирон
fontarney - фонтарней; en - фонтэрни
batiste - батисте; en - бейтист
compagnie - cомпагние; fra - компайн
soaps - соапс; en - соапс
errazuriz - эрразуриз; en - эррэзериз
gals - галс; en - гэлс
create your monster - cреате йоур монстер; en - крит иоер монстер
angry - ангри; en - ангри
loubaney - лоубаней; fra - лубанеи
lebrun - лебрун; en - лебран
gertrude - гертруде; en - джертрьюд
vplab - вплаб; en - вплэб
balance - баланcе; fra - баланс
deveron - деверон; en - дивирон
amiot guy - амиот гуй; en - амиот гуи
beam - беам; en - бим
in a - ин а; en - ин а
mosconi - мосcони; en - москони
taillade - таилладе; ita - таилладе
design bobby - десигн бобби; en - дезайгн бобби
oat - оат; en - оэт
sublime - сублиме; en - саблим
l'atelier du - лателиер ду; fra - лателиер ду
chamcalet - чамcалет; en - чэмкейлет
lv - лв; en - лв
tampax - тампакс; en - тэмпэкс
three - трее; en - сре
arboleda - арболеда; en - арболида
buis - буис; en - буис
diar - диар; en - диар
bandarossa - бандаросса; ita - бандаросса
bellingham insignia serie - беллингхам инсигниа серие; en - беллингхэм инсайгниа серай
belveder - белведер; en - белвидер
dal - дал; en - дэл
jamie - джамие; en - джэмай
alce - алcе; en - алс
stronachie - строначие; en - стронэчай
men - мен; en - мен
fiorente - фиоренте; en - фиорент
gerardo - герардо; en - джирэрдо
veuve - веуве; en - вьюв
larionov select - ларионов селеcт; en - лейрионов силект
siberica - сибериcа; ita - сиберика
voloute - волоуте; fra - волут
bubbies - буббиес; en - баббис
marbelle - марбелле; ita - марбелле
le perd - ле перд; fra - ле перд
polje - полдже; en - полдж
jurassic - джурассиc; en - джерэссик
banfi - банфи; en - бэнфи
konitz - конитз; ger - конитц
d`aurilhac - д`аурилхаc; en - д`эерилхэк
caldora - cалдора; en - кэлдора
cantine - cантине; en - кэнтин
zlato - злато; ger - цлато
pate - пате; ita - пате
jens - дженс; en - дженс
corinto - cоринто; en - коринто
thierry et - тиерри эт; en - зиерри эт
chapelle - чапелле; ita - капелле
chateau la croix - чатеау ла cроикс; fra - шато ла круа
wax - вакс; en - вэкс
rouge du - роуге ду; fra - руж ду
marmaluzi - мармалузи; en - мэрмэльюзи
procomfort - проcомфорт; en - прокомфорт
private - привате; en - привейт
lattesso - латтессо; ita - латтессо
horst - хорст; ger - горшт
familia deicas - фамилиа деиcас; en - феймилиа деикэс
barde-haut - барде-хаут; en - бэрде-хоат
sensei la - сенсеи ла; fra - сенсеи ла
maison du - маисон ду; fra - маизон ду
siaurac - сиаураc; fra - сиаурак
bonsai - бонсаи; en - бонсаи
chateau phelan - чатеау фелан; fra - шато фелан
antico molino - антиcо молино; ita - антико молино
mont'arquato - монтарквато; en - монтэрквато
domaine yves - домаине ивес; en - домаин ивес
compania - cомпаниа; en - компейниа
distillerie - дистиллерие; ita - дистиллерие
cellar - cеллар; en - селлэр
head - хеад; en - хид
milla halal - милла халал; ita - милла халаль
glenrothes - гленротес; en - гленрозес
porta di - порта ди; ita - порта ди
aloins - алоинс; en - алоинс
serra - серра; ita - серра
r.a.w.life - р.а.в.лифе; en - р.э.в.лиф
health - хеалт; en - хилс
sohni-wicke - сохни-вике; en - сохни-вик
marquesa de - марквеса де; fra - марквеза де
chateau la tuilerie - чатеау ла туилерие; fra - шато ла туилери
ecover - эcовер; en - эковер
corporation - cорпоратион; en - корпорэшен
bouey - боуей; fra - буеи
hennessy - хеннесси; en - хеннесси
andre's - андрес; en - андрес
frau - фрау; en - фроу
birra - бирра; ita - бирра
azzuro - аззуро; ita - аццуро
teta - тета; ita - тета
teeny - теени; en - тини
isme - исме; en - исм
vina - вина; ita - вина
freunde - фреунде; en - фрьюнд
1st - 1ст; ger - 1шт
raison - раисон; en - раизон
kosta - коста; en - коста
guir - гуир; en - гаер
grand-mere - гранд-мере; en - грэнд-мир
cantemerle - cантемерле; en - кэнтимерл
lagoon - лагоон; en - лейгун
alnardo - алнардо; en - алнэрдо
pomi - поми; ita - поми
bodegas horacio - бодегас хораcио; en - бодигэс хорейсио
heidi - хеиди; en - хеиди
yaokin - яокин; en - яокин
maro'schip43 - марошип43; ger - марошип43
fairview - фаирвиев; en - фэервив
ashmead - ашмеад; en - ашмид
rothschild - ротшилд; ger - ротхшилд
hoegaarden - хоегаарден; en - хоегаарден
shur - шур; en - шер
wings - вингс; en - вингс
imball - имбалл; en - имбол
l'oreal skin - лореал скин; en - лорил скин
jump energy - джумп энерги; en - джамп энерджи
eley - элей; en - эли
dagueneau & - дагуенеау &; fra - дагуено &
leoville - леовилле; ita - леовилле
vecchio - веcчио; en - векчио
eisele vineyard estate - еиселе винеярд эстате; en - еизил виниярд эстейт
amstel - амстел; ger - амштел
familia - фамилиа; en - феймилиа
l'or - лор; en - лор
adriona - адриона; en - адриона
china plum - чина плум; en - чина плам
mepsi - мепси; en - мепси
ulysse - улиссе; ita - улиссе
estelare institute - эстеларе институте; ger - эштеларе инштитуте
traditional messori - традитионал мессори; en - трейдишенэл мессори
americo - америcо; en - амирико
hacker-pschorr - хакер-пшорр; ger - гаккер-пшорр
grolsch - гролш; ger - гролш
foods - фоодс; en - фудс
descendientes - десcендиентес; en - дессендинтес
warmies - вармиес; en - вормис
boddingtons - боддингтонс; en - боддингтонс
larionov - ларионов; en - лейрионов
similac - симилаc; en - симилэк
lafarg - лафарг; en - лейфэрг
wellery - веллери; en - веллири
chillafish bunzi - чиллафиш бунзи; ger - киллафиш бунзи
top - топ; en - топ
vega del - вега дел; ita - вега дель
vaily - ваили; en - ваили
domini - домини; ita - домини
porcelaine czech gold - порcелаине cзеч голд; ger - поркелаине кзех голд
big - биг; en - биг
nanoprotech - нанопротеч; en - нейнопротеч
czech gold - cзеч голд; ger - кзех голд
myron - мирон; en - майрон
kiwi - киви; ita - киви
soroci - сороcи; ita - сорочи
rodez - родез; en - родез
ode to - оде то; ita - оде то
supermario - супермарио; en - сьюпермейрио
les grands houx - лес грандс хоукс; fra - ле грандс хо
gasnier - гасниер; en - гэснир
tero - теро; ita - теро
town - товн; en - товн
soft - софт; en - софт
rivers - риверс; en - риверс
lagavulin - лагавулин; en - лейгэвьюлин
face - фаcе; ita - фаче
marques de - марквес де; fra - марквес де
treatment - треатмент; en - тритмент
isobel - исобел; en - изобел
agricola san - агриcола сан; en - агрикола сэн
cup - cуп; en - кап
d'anjou - данджоу; fra - данжу
beef.on - бееф.он; en - биф.он
marchesi - марчеси; en - мэрчизи
domaine georges - домаине георгес; en - домаин джирджес
hero - херо; ita - херо
potensac - потенсаc; en - потенсэк
pasta del - паста дел; en - пэста дел
boulangere - боулангере; fra - буланжер
mat&lou - мат&лоу; fra - мат&лу
hillway - хиллвай; en - хиллвей
berlinger - берлингер; en - берлинджер
clear - cлеар; en - клир
cristoforo - cристофоро; en - кристофоро
aqa - ака; en - ака
expertise - экспертисе; en - экспертиз
wolpertinger - волпертингер; en - волпертинджер
snack - снак; en - снэк
blanc du - бланc ду; fra - бланк ду
founders - фоундерс; fra - фундерс
castillo de - cастилло де; ita - кастилло де
ma - ма; ita - ма
kendermann - кендерманн; en - кендермэнн
almaviva - алмавива; en - алмейвива
cereals - cереалс; en - серилс
cow - cов; en - коу
smartwater - смартватер; en - смэртвейтер
anselmi - анселми; en - анселми
las - лас; en - лэс
co - cо; ita - ко
original - оригинал; en - ориджинэл
munchkin - мунчкин; en - манчкин
reyka - реика; en - реика
ritinitis - ритинитис; en - ритинитис
mondoro - мондоро; en - мондоро
sheridan's - шериданс; en - ширидэнс
trest - трест; en - трест
cru - cру; en - кру
lunaris - лунарис; en - льюнейрис
gefu - гефу; ita - джефу
juicy - джуиcи; en - джуиси
newcastle - невcастле; en - ньюкэстл
felice - фелиcе; ita - феличе
xl-s - ксл-с; en - ксл-с
margaux - маргаукс; fra - маргаукс
luxplast - лукспласт; en - лаксплэст
des deux - дес деукс; fra - дес деукс
living - ливинг; en - ливинг
elisabeth - элисабет; en - элизейбес
podere - подере; ita - подере
siciliana - сиcилиана; en - сисилиана
ferme - ферме; en - ферм
orihiro - орихиро; en - орихеро
nissan - ниссан; en - ниссэн
cornetto - cорнетто; ita - корнетто
hill's - хиллс; en - хиллс
bouchard pere & - боучард пере &; fra - бушард пер &
kurt - курт; en - керт
kesper - кеспер; en - кеспер
d`orfeuilles - д`орфеуиллес; fra - д`орфеуиллес
angus - ангус; en - ангас
gaitero - гаитеро; en - гаитиро
gartenz de - гартенз де; ger - гартенц де
j.m - дж.м; en - дж.м
fourcas-borie - фоурcас-борие; fra - фуркас-бори
chateau certan de - чатеау cертан де; fra - шато кертан де
gouges - гоугес; fra - гужс
pellehaut harmonie - пеллехаут хармоние; en - пеллехоат хэрмонай
miyoshi - мииоши; en - мииоши
cecu - cеcу; ita - чеку
walsh - валш; en - вэлш
daler - далер; en - дейлер
calabria family - cалабриа фамили; en - кейлэбриа феймили
greengate - греенгате; en - грингейт
gras - грас; en - грэс
domaine de valescure - домаине де валесcуре; fra - домаин де валескур
strock brot - строк брот; en - строк брот
eco - эcо; en - эко
tiger - тигер; en - тиджер
strock - строк; en - строк
montrose - монтросе; en - монтроз
solan - солан; en - солэн
kitchen&love - китчен&лове; en - китчен&лов
barade - бараде; ita - бараде
frapin - фрапин; en - фрейпин
parastone - парастоне; en - пейрэстон
british - бритиш; en - бритиш
gazin - газин; en - гейзин
atiza - атиза; en - атиза
miracle - мираcле; en - мерэкл
everyday - эверидай; en - эвиридей
mann - манн; en - мэнн
gatsby - гацби; en - гэтсби
1862 - 1862; en - 1862
zwilling - звиллинг; ger - цвиллинг
bongo - бонго; en - бонго
touque - тоукве; fra - тук
bridge - бридге; en - бриддж
sucran - суcран; en - сакрэн
podere san - подере сан; ita - подере сан
mil - мил; en - мил
bodega - бодега; ita - бодега
nero - неро; ita - неро
erlenbacher - эрленбачер; en - эрленбэчер
scotti - сcотти; ita - скотти
igor larionov select - игор ларионов селеcт; en - игор лейрионов силект
bruck - брук; en - брак
duvel - дувел; en - дьювел
pellegrino - пеллегрино; ita - пеллегрино
intercon - интерcон; en - интеркон
fraicheur - фраичеур; fra - фраишеур
octa - оcта; en - окта
rocher - рочер; en - рочер
domaine pierre - домаине пиерре; ita - домаине пиерре
amt - амт; en - амт
le conserve della - ле cонсерве делла; ita - ле консерве делла
faustino - фаустино; en - фоастино
mill - милл; en - милл
house - хоусе; fra - хуз
head old - хеад олд; en - хид олд
segur - сегур; en - сегер
leoville-barton - леовилле-бартон; ita - леовилле-бартон
flor - флор; en - флор
marseillais - марсеиллаис; en - мэрсеиллаис
longueville - лонгуевилле; ita - лонгуевилле
frederic - фредериc; en - фридирик
crista - cриста; en - криста
pate grand - пате гранд; en - пейт грэнд
legitime - легитиме; ita - леджитиме
koopman international - коопман интернатионал; en - купмэн интернэшенэл
truefitt - труефитт; en - трьюфитт
route - роуте; fra - рут
cape - cапе; ita - капе
han all daeng - хан алл даенг; en - хэн ол даенг
burn stewart - бурн стеварт; ger - бурн штеварт
noellat - ноеллат; en - ноеллэт
gendres - гендрес; en - джендрес
project - проджеcт; en - проджект
biologiques - биологиквес; fra - биоложиквес
miel - миел; en - мил
jazz - джазз; ger - язц
maison - маисон; en - маизон
colterenzio - cолтерензио; en - колтирензио
duncan s of - дунcан с оф; en - данкэн с оф
lebelage - лебелаге; ita - лебеладже
silver - силвер; en - силвер
beautysweeties - беаутисвеетиес; en - биьютисвитис
reina - реина; en - реина
verdier - вердиер; en - вердир
orenbeef - оренбееф; en - оренбиф
gurgue - гургуе; en - гергу
serene - серене; ita - серене
alees de - алеес де; fra - алеес де
frantoio di santa - франтоио ди санта; ita - франтоио ди санта
olmeca - олмеcа; en - олмика
fiorini - фиорини; en - фиорини
cornale - cорнале; en - корнейл
toffly - тоффли; en - тоффли
classico - cлассиcо; ita - классико
premium - премиум; en - примиум
ylvi - илви; en - илви
le perd son - ле перд сон; fra - ле перд сон
classics - cлассиcс; en - клэссикс
ballantine's - баллантинес; en - болэнтинес
every - эвери; en - эвири
madli - мадли; en - мэдли
ipkn - ипкн; en - ипкн
tm - тм; en - тм
leithakalk - леитакалк; en - леизейкэлк
durfort-vivens - дурфорт-вивенс; en - дерфорт-вивенс
hour - хоур; fra - хур
metreveli - метревели; en - метривили
moly - моли; en - моли
pedison - педисон; en - пидизон
yur - йур; en - иер
volkomolko - волкомолко; en - волкомолко
yotuel - йотуел; en - иотьюл
cos - cос; en - кос
henri - хенри; en - хенри
klee - клее; en - кле
fattoria del - фатториа дел; ita - фатториа дель
bodegas - бодегас; en - бодигэс
plantagenet - плантагенет; en - плэнтэджинет
rouet - роует; fra - рует
palmia - палмиа; en - пэлмиа
grand cru classe - гранд cру cлассе; en - грэнд кру клэсс
holika - холика; ita - холика
welcos - велcос; en - велкос
angelus - ангелус; en - анджилас
gastronomie - гастрономие; en - гэстрономай
sacha - сача; en - сэча
delirio - делирио; en - делерио
black - блак; en - блэк
marolo - мароло; ita - мароло
microboats - миcробоац; en - микробоатс
milco - милcо; en - милко
argana - аргана; en - аргейна
drinks - дринкс; en - дринкс
vie - вие; en - вай
palais des - палаис дес; en - пейлаис дес
chat - чат; en - чэт
sirene de - сирене де; fra - сирен де
tree - трее; en - тре
specialites - спеcиалитес; en - списиолитес
albarino - албарино; en - албейрино
aquafarm - аквафарм; en - аквафэрм
crisnalinas - cрисналинас; en - криснейлинэс
saponaria - сапонариа; en - сейпонейриа
emile - эмиле; en - эмил
gallery - галлери; en - голири
le carillon de - ле cариллон де; fra - ле кариллон де
marc colin - марc cолин; en - мэрк колин
churchill - чурчилл; ger - курхилл
la dame de - ла даме де; fra - ла дам де
lactimilk - лаcтимилк; en - лэктимилк
tremblay - тремблай; en - тремблей
panelux - панелукс; fra - панелюкс
bago - баго; ita - баго
from - фром; en - фром
dei - деи; en - деи
vertine - вертине; en - вертин
les quatre - лес кватре; fra - ле кватр
igloo - иглоо; en - иглу
mlinar - млинар; en - млинэр
monmousseau - монмоуссеау; fra - монмуссо
domaine comte georges - домаине cомте георгес; en - домаин комт джирджес
case basse - cасе бассе; ita - касе бассе
peppadoro - пеппадоро; ita - пеппадоро
badger - бадгер; en - бэдджер
rauzan-segla - раузан-сегла; en - роьюзэн-сегла
barbers - барберс; en - бэрберс
eclat - эcлат; en - эклэт
kampot - кампот; en - кэмпот
ivory - ивори; en - ивори
larquey - ларквей; fra - ларквеи
tsakiris - цакирис; en - тсэкерис
ruliano - рулиано; en - рьюлиано
for - фор; en - фор
solutions - солутионс; en - солашенс
william - виллиам; en - виллиам
blanton's - блантонс; en - блэнтонс
image - имаге; en - имэдж
tertre - тертре; en - тертр
de graaf - де грааф; fra - де грааф
quickbury - квикбури; en - квикбери
emilio - эмилио; en - эмилио
paul - паул; en - поал
scottish - сcоттиш; en - скоттиш
shibucli - шибуcли; en - шибакли
la closerie de - ла cлосерие де; fra - ла клозери де
mr.proper - мр.пропер; en - мр.пропер
s of - с оф; en - с оф
frautest - фраутест; en - фроьютест
coolvit - cоолвит; en - кулвит
dec - деc; en - дек
tatsuuma - тацуума; en - тэтсуума
lions - лионс; en - лионс
lorraine - лорраине; ita - лорраине
so-men - со-мен; ita - со-мен
liberal - либерал; en - либирэл
la vieja - ла виеджа; fra - ла виежа
qnt - кнт; en - кнт
sierra - сиерра; ita - сиерра
lyonnat - лионнат; en - лионнэт
tognetti - тогнетти; ita - тогнетти
oban - обан; en - обэн
kanguru - кангуру; en - кэнгеру
& tim ice - & тим иcе; en - & тим ис
louis - лоуис; fra - луис
noya - ноя; en - ноя
duclaux famille - дуcлаукс фамилле; fra - дуклаукс фамилле
ashmead grand - ашмеад гранд; en - ашмид грэнд
eat - еат; en - ит
chateau du - чатеау ду; fra - шато ду
il gusto della - ил густо делла; en - ил гасто делла
village - виллаге; ita - вилладже
schokolade - шоколаде; ger - шоколаде
guillaume - гуиллауме; ita - гуиллауме
koln - колн; en - колн
la dame - ла даме; fra - ла дам
bluesea - блуесеа; en - бльюси
tibet's - тибец; en - тибетс
delifrance - делифранcе; fra - делифранс
walsh whiskey - валш вхискей; en - вэлш вхиски
momi - моми; ita - моми
nella - нелла; ita - нелла
message - мессаге; ita - мессадже
zaks - закс; en - зэкс
touch in - тоуч ин; fra - туш ин
botanicals - ботаниcалс; en - ботейникэлс
feudi - феуди; en - фьюди
les pelerins - лес пелеринс; fra - ле пелеринс
philipponnat - филиппоннат; en - филиппоннэт
bottle - боттле; en - боттл
bara - бара; ita - бара
la taille aux - ла таилле аукс; fra - ла телле аукс
koelf - коелф; en - коелф
camensac - cаменсаc; en - кейменсэк
la rose des - ла росе дес; fra - ла роз дес
hosanna - хосанна; en - хозэнна
nigl - нигл; en - нигл
confiserie - cонфисерие; en - конфизерай
xtreme - кстреме; en - кстрим
let's - лец; en - летс
les celliers - лес cеллиерс; fra - ле келлиерс
malescot - малесcот; en - мейлескот
connetable de - cоннетабле де; fra - коннетабле де
junlove - джунлове; en - джанлов
vandemoortele - вандемоортеле; en - вэндимоортил
roger - рогер; en - роджер
requingua - реквингуа; en - риквингуа
duplessis - дуплессис; en - даплессис
felton - фелтон; en - фелтон
pierre - пиерре; ita - пиерре
stuff - стуфф; en - стафф
zwilling j.a - звиллинг дж.а; ger - цвиллинг й.а
reine - реине; en - реин
bowmore - бовморе; en - бовмор
blason d' - бласон д; en - блейзон д
fattoria - фатториа; ita - фатториа
kindl - киндл; en - кайндл
du-casse - ду-cассе; ita - ду-кассе
duc de - дуc де; fra - дук де
rouge - роуге; fra - руж
nature - натуре; ita - натуре
schrader - шрадер; ger - шрадер
plunger - плунгер; en - планджер
nature love - натуре лове; ita - натуре лове
tic - тиc; en - тик
bulbbotz - булбботз; ger - булбботц
julius - джулиус; en - джьюлиус
play-doh - плаи-дох; en - плей-дох
wilmax - вилмакс; en - вилмэкс
vie di - вие ди; ita - вие ди
zemsa - земса; en - земса
aimery - аимери; en - аимири
e-towel - е-товел; en - е-товел
grand corbin - гранд cорбин; en - грэнд корбин
wellaflex - веллафлекс; en - веллэфлекс
chapelle de - чапелле де; ita - капелле де
vivienne - вивиенне; en - вивинн
chateau fourcas - чатеау фоурcас; fra - шато фуркас
chateau de - чатеау де; fra - шато де
frutta - фрутта; ita - фрутта
naro - наро; ita - наро
flex - флекс; en - флекс
mar - мар; en - мэр
sangouard - сангоуард; fra - сангуард
castelneau - cастелнеау; fra - кастелно
chateau single - чатеау сингле; fra - шато сингле
finn - финн; en - финн
samyang - самянг; en - сеймянг
tartufi - тартуфи; en - тэртьюфи
janarat - джанарат; en - джейнейрэт
hermanos - херманос; en - хермейнос
darroze - даррозе; ita - даррозе
let - лет; en - лет
quiot - квиот; fra - квиот
dauphin - дауфин; en - доафин
parazols - паразолс; en - пейрейзолс
maipo - маипо; en - маипо
valescure - валесcуре; en - вейлескер
lyngrove - лингрове; en - лингров
generation - генератион; en - джинирэшен
lalande-borie - лаланде-борие; en - лейлэнде-борай
33 - 33; en - 33
japanese - джапанесе; ita - жапанесе
patron - патрон; en - пэтрон
sauce - сауcе; en - соьюс
quattrociocchi - кваттроcиоcчи; en - кваттросиокчи
weingut reichsgraf von - веингут реичсграф вон; ger - вейнгут рейхсграф фон
og - ог; en - ог
duncan s - дунcан с; en - данкэн с
simply - симпли; en - симпли
lacor - лаcор; en - лейкор
buttermilk - буттермилк; en - баттермилк
murier - муриер; en - мерир
poujeaux - поуджеаукс; fra - пужокс
napoli - наполи; ita - наполи
talisker - талискер; en - тейлискер
marchesi de' - марчеси де; fra - маршези де
domaine - домаине; en - домаин
la maison - ла маисон; fra - ла маизон
bebian - бебиан; en - бибиан
lignier - лигниер; en - лайгнир
mission - миссион; en - мишн
goose - гоосе; en - гуз
maitre de - маитре де; fra - метр де
winery - винери; en - винири
gomez - гомез; en - гомез
sea - сеа; en - си
l'orfevrerie - лорфеврерие; en - лорфеврерай
han all - хан алл; en - хэн ол
domaine marc - домаине марc; en - домаин мэрк
bionova - бионова; en - бионова
ringo - ринго; en - ринго
montifaud - монтифауд; en - монтифоад
aranleon - аранлеон; en - арэнлин
yavne - явне; en - явн
nuts - нуц; en - натс
birds - бирдс; en - бердс
cepa - cепа; ita - чепа
bodegas horacio gomez - бодегас хораcио гомез; en - бодигэс хорейсио гомез
chiharu - чихару; en - чихейру
ambal - амбал; en - амбэл
kirchepfad - кирчепфад; en - керчепфэд
tech - теч; en - теч
gusti - густи; en - гасти
biona - биона; en - биона
scarlinpizza - сcарлинпизза; ita - скарлинпицца
chateau - чатеау; fra - шато
niteize - нитеизе; en - нитеиз
bodegas venta - бодегас вента; en - бодигэс вента
loic - лоиc; en - лоик
velenosi - веленоси; ita - веленоси
browne - бровне; en - бровн
riso - рисо; ita - рисо
chateau lalande - чатеау лаланде; fra - шато лаланд
domaines - домаинес; en - домаинес
umbre - умбре; en - юмбр
l'etivaz - летиваз; en - литивэз
de' - де; fra - де
grain - граин; en - граин
milla - милла; ita - милла
simplygreen - симплигреен; en - симплигрин
ginestet - гинестет; en - джинестет
salubrious - салубриоус; fra - салюбриус
bounty - боунти; fra - бунти
les pagodes de - лес пагодес де; fra - ле пагодес де
byrne - бирне; en - бирн
chartogne-taillet - чартогне-таиллет; en - чэртогне-таиллет
de l'lle - де ллле; fra - де ллле
flirt - флирт; en - флерт
take - таке; ita - таке
grosperrin - гросперрин; en - гросперрин
joseph phelps - джосеф фелпс; en - джозеф фелпс
domaine duclaux - домаине дуcлаукс; fra - домаин дуклаукс
parent - парент; en - пейрент
chateau pichon longueville - чатеау пичон лонгуевилле; fra - шато пишон лонгуевилле
inter-vion - интер-вион; en - интер-вион
ale - але; en - ал
glassware - глассваре; en - глэссвор
sorrel - соррел; en - соррел
milk - милк; en - милк
pavillon blanc - павиллон бланc; en - пейвиллон блэнк
biomeals - биомеалс; en - биомилс
molisana - молисана; ita - молисана
cattoni - cаттони; ita - каттони
d'la - дла; en - дла
perd son - перд сон; en - перд сон
pagodes - пагодес; en - пейгодес
viet - виет; en - вит
vanajan - ванаджан; en - вейнейджэн
umbra - умбра; en - юмбра
fromnature - фромнатуре; en - фромнэтер
domaine serge dagueneau - домаине серге дагуенеау; fra - домаин серж дагуено
granny`s - гранни`с; en - грэнни`с
rougie - роугие; fra - руж
trillol - триллол; en - триллол
boucherie - боучерие; fra - бушери
14-18h - 14-18х; en - 14-18х
chateau belle - чатеау белле; fra - шато белле
solan de - солан де; fra - солан де
grant - грант; en - грэнт
vegdiet - вегдиет; en - вегдит
d'ours - доурс; fra - дурс
ruinart - руинарт; en - руинэрт
organika - органика; en - оргейника
putty - путти; en - патти
say - сай; en - сей
seishu - сеишу; en - сеишу
bleuets - блеуец; fra - блеуетс
dead - деад; en - дид
rim - рим; en - рим
zotter - зоттер; en - зоттер
principe - принcипе; en - принсип
zira - зира; ita - зира
dnc - днc; en - днк
wonder - вондер; en - вондер
otard - отард; en - отэрд
milmil - милмил; en - милмил
carbonnieux - cарбонниеукс; fra - карбонниеукс
bondelamar - бонделамар; en - бонделеймэр
pureprotein - пурепротеин; en - перепротеин
welch - велч; en - велч
hakodate - хакодате; ita - хакодате
les grands - лес грандс; fra - ле грандс
pontet-canet - понтет-cанет; en - понтет-кейнет
bodybar - бодибар; en - бодайбэр
gardine - гардине; en - гэрдин
edouard - эдоуард; fra - эдуард
macquin - маcквин; en - мэкквин
finca la - финcа ла; fra - финка ла
techniques - течниквес; fra - тешниквес
skin79 - скин79; en - скин79
blason - бласон; en - блейзон
brio de - брио де; fra - брио де
carte - cарте; en - кэрт
novi - нови; ita - нови
domaine thierry - домаине тиерри; en - домаин зиерри
ama - ама; en - ама
5th - 5т; en - 5с
pere - пере; ita - пере
orrefors - оррефорс; en - оррифорс
latour - латоур; fra - латур
nayuta - наиута; en - нейьюта
gresser - грессер; en - грессер
shadrapa - шадрапа; en - шэдрейпа
rrcup - ррcуп; en - рркап
nut - нут; en - нат
urbani - урбани; en - ербейни
your monster - йоур монстер; en - иоер монстер
negro - негро; en - негро
chelsea - челсеа; en - челси
1882 - 1882; en - 1882
dorset - дорсет; en - дорсет
xaax - ксаакс; en - ксаакс
worcester - ворcестер; en - ворсестер
alter ego - алтер эго; en - алтер эго
the purple - те пурпле; en - зе перпл
two - тво; en - тво
fieuzal - фиеузал; fra - фиеузал
napa - напа; ita - напа
papa - папа; ita - папа
la miso la - ла мисо ла; fra - ла мизо ла
chateau la mission - чатеау ла миссион; fra - шато ла миссион
salton - салтон; en - сэлтон
montelobos - монтелобос; en - монтилобос
grouse - гроусе; fra - груз
bakeries - бакериес; en - бейкерис
vacuvin - ваcувин; en - вэкьювин
cabras - cабрас; en - кэбрэс
starbucks - старбукс; en - стэрбакс
marianna - марианна; en - мейрианна
rivage - риваге; ita - ривадже
veyrac - веираc; en - веирэк
rose - росе; ita - росе
bonhoste - бонхосте; en - бонхост
kelsen - келсен; en - келсен
calidris - cалидрис; en - кейлидрис
heathcote & - хеатcоте &; en - хизкот &
bellevue - беллевуе; ita - беллевью
friskies - фрискиес; en - фрискис
47 - 47; en - 47
origin - оригин; en - ориджин
ever - эвер; en - эвер
superiore - супериоре; en - сьюпириор
spa by - спа би; en - спа би
quattro - кваттро; en - кваттро
eco norang - эcо норанг; en - эко норэнг
grase - грасе; en - грейз
eat water - еат ватер; en - ит вейтер
belvedere - белведере; en - белвидир
spol.s.r.o - спол.с.р.о; en - спол.с.р.о
gusto - густо; en - гасто
gilles - гиллес; fra - жиллес
pierre gimonnet & - пиерре гимоннет &; en - пирр джимоннет &
terra del - терра дел; ita - терра дель
abbot - аббот; en - аббот
rudd - рудд; en - радд
origami - оригами; en - оригейми
du - ду; fra - ду
dias - диас; en - диас
eggenberg - эггенберг; en - эгдженберг
jumex - джумекс; en - джьюмекс
d'ardhuy - дардхуй; en - дэрдхуи
3w - 3в; en - 3в
van - ван; en - вэн
rich - рич; en - рич
the town - те товн; en - зе товн
brunier - бруниер; en - брьюнир
haut-beausejour - хаут-беауседжоур; fra - хаут-босежур
rosiers - росиерс; en - розирс
talbot - талбот; en - тэлбот
serge dagueneau - серге дагуенеау; fra - серж дагуено
biomio - биомио; en - биомио
always ultra platinum - алваис ултра платинум; en - алвейс юлтра плейтинам
augustiner - аугустинер; en - оьюгастинер
blume - блуме; en - бльюм
prats - прац; en - прэтс
bonny doon - бонни доон; en - бонни дун
barbara - барбара; en - бэрбейра
alfonso - алфонсо; en - алфонсо
dog - дог; en - дог
kmpc - кмпc; en - кмпк
dalem - далем; en - дейлем
matignon - матигнон; en - мэтайгнон
guy - гуй; en - гуи
mevioil - мевиоил; fra - мевиуал
madama - мадама; ita - мадама
zab - заб; en - зэб
renewal - реневал; en - ринивэл
isntree - иснтрее; en - иснтре
alpro - алпро; en - алпро
doon - доон; en - дун
brocard - броcард; en - брокэрд
traditional - традитионал; en - трейдишенэл
finist - финист; en - финист
antipodes - антиподес; en - антиподес
paul and - паул анд; en - поал анд
duchesse de - дучессе де; ita - дукессе де
calabria - cалабриа; en - кейлэбриа
mette - метте; ita - метте
drogheria e - дрогхериа э; en - дрогхириа э
pantene - пантене; en - пэнтин
veneti - венети; ita - венети
providence - провиденcе; en - провиденс
jim - джим; en - джим
i lecci - и леccи; ita - и леччи
graymelin - граимелин; en - греймилин
tempio - темпио; en - темпио
mediterranean olive - медитерранеан оливе; en - мидитеррэнин олив
pavillon rouge du - павиллон роуге ду; fra - павиллон руж ду
pelerins de - пелеринс де; fra - пелеринс де
payne - паине; en - пейн
bohemia - бохемиа; en - бохимиа
american - америcан; en - амирикэн
bobby - бобби; en - бобби
lovers - ловерс; en - ловерс
pavie - павие; en - пэвай
perla - перла; en - перла
maker's - макерс; en - мейкерс
j.a - дж.а; en - дж.а
geoffroy - геоффрой; en - джиффрои
pepper - пеппер; en - пеппер
revolution - револутион; en - риволашен
seleccionada - селеccионада; ita - селеччионада
nimbus - нимбус; en - нимбас
bouchon - боучон; fra - бушон
helios - хелиос; en - хилиос
gravner - гравнер; en - грэвнер
epica - эпиcа; en - эпика
domaine lafarge - домаине лафарге; en - домаин лейфэрдж
tov - тов; en - тов
geomar - геомар; en - джимэр
dino - дино; ita - дино
fantasy - фантаси; en - фэнтейзи
zolla - золла; ita - золла
grasso - грассо; ita - грассо
double - доубле; fra - дубле
finlaggan - финлагган; en - финлэггэн
montpezat - монтпезат; en - монтпизэт
bat - бат; en - бэт
doudou et - доудоу эт; fra - дуду эт
excellence - эксcелленcе; ita - эксчелленче
chateau cote - чатеау cоте; fra - шато кот
moulin de - моулин де; fra - мулин де
award - авард; en - оворд
porfia - порфиа; en - порфиа
marc colin et - марc cолин эт; en - мэрк колин эт
soupline - соуплине; fra - суплин
baer - баер; en - баер
momotani - момотани; ita - момотани
khiri - кхири; en - кхери
daeng gi - даенг ги; en - даенг джи
chikori - чикори; en - чикори
european - еуропеан; fra - европеан
filippo - филиппо; ita - филиппо
andre - андре; en - андр
pearl - пеарл; en - пирл
bodegas san - бодегас сан; en - бодигэс сэн
ellelhotse - эллелхоце; ita - эллелхотсе
grivot - гривот; en - гривот
saint - саинт; en - саинт
ricami - риcами; ita - риками
laphroaig - лафроаиг; fra - лафроаиж
bialetti - биалетти; ita - биалетти
the stump - те стумп; ger - тхе штумп
gimonnet - гимоннет; en - джимоннет
varoilles - вароиллес; fra - варуаллес
et pascale - эт пасcале; en - эт пэскейл
daniel's - даниелс; en - дейнилс
mon tero eco - мон теро эcо; en - мон тиро эко
remondo - ремондо; en - римондо
spiced - спиcед; en - списед
trolls - троллс; en - троллс
nano - нано; ita - нано
disaronno - дисаронно; en - дизейронно
la croix - ла cроикс; fra - ла круа
majorette - маджоретте; ita - мажоретте
matti - матти; ita - матти
dodici - додиcи; ita - додичи
lagune - лагуне; ita - лагуне
giacomo - гиаcомо; en - джиакомо
vignerons de l'lle - вигнеронс де ллле; fra - вигнеронс де ллле
genki - генки; en - дженки
sanosan - саносан; en - сейнозэн
baruffaldi - баруффалди; en - бейраффэлди
gekkeikan - геккеикан; en - джеккеикэн
himalaya - хималая; en - химэлейа
frank's - франкс; en - фрэнкс
perron - перрон; en - перрон
alees - алеес; en - алис
thalgo - талго; en - сэлго
take a slim - таке а слим; en - тейк а слим
mako - мако; ita - мако
fackelmann - факелманн; en - фэкелмэнн
corine de - cорине де; fra - корин де
charles - чарлес; fra - шарлес
hedges&butler - хедгес&бутлер; en - хедджес&батлер
rieussec - риеуссеc; fra - риеуссек
shim - шим; en - шим
royale - рояле; en - роиол
be - бе; ita - бе
pollino - поллино; ita - поллино
australian by - аустралиан би; en - оастрейлиан би
antica - антиcа; en - антика
tena - тена; ita - тена
petstages - пецтагес; ger - петштагес
hinijini - хиниджини; ita - хинижини
comtesse - cомтессе; ita - комтессе
ptit - птит; en - птит
colin et - cолин эт; en - колин эт
dagueneau - дагуенеау; fra - дагуено
salviano - салвиано; en - сэлвиано
camellia - cамеллиа; ita - камеллиа
monsier - монсиер; en - монсир
xz - ксз; en - ксз
diamond - диамонд; en - диамонд
longueville comtesse de - лонгуевилле cомтессе де; ita - лонгуевилле комтессе де
spice - спиcе; en - спис
nada nothing - нада нотинг; ita - нада нотхинг
steelpower - стеелповер; en - стилповер
kesidis - кесидис; en - кизидис
fiddes - фиддес; en - фиддес
la roque - ла рокве; fra - ла рок
anchors - анчорс; en - анчорс
connetable - cоннетабле; en - коннитэбл
1698 - 1698; en - 1698
pintia - пинтиа; en - пинтиа
v-fit - в-фит; en - в-фит
violeta - виолета; en - виолита
livinghouse - ливингхоусе; fra - ливингхуз
aizu - аизу; en - аизу
lecci della - леccи делла; ita - леччи делла
drive for - дриве фор; en - дрив фор
les vignobles - лес вигноблес; fra - ле вигноблес
stick - стик; en - стик
helga - хелга; en - хелга
of origin - оф оригин; en - оф ориджин
lejay - леджай; en - леджей
terramater - терраматер; en - терреймейтер
sota - сота; ita - сота
les pelerins de - лес пелеринс де; fra - ле пелеринс де
silva - силва; en - силва
couprie - cоуприе; fra - купри
la tour de - ла тоур де; fra - ла тур де
mayrac - маираc; en - мейрэк
efendi - эфенди; en - эфенди
bouchaud - боучауд; fra - бушауд
basse di gianfranco - бассе ди гианфранcо; en - бэсс ди джианфрэнко
riedel - риедел; en - ридел
herbarus - хербарус; en - хербейрас
grunwelt - грунвелт; en - гранвелт
chateau de la - чатеау де ла; fra - шато де ла
la haute - ла хауте; fra - ла хаут
sogni di - согни ди; ita - согни ди
de cantenac - де cантенаc; fra - де кантенак
tomato - томато; ita - томато
gilette - гилетте; ita - джилетте
1volta - 1волта; en - 1волта
weider - веидер; en - веидер
jemo - джемо; ita - жемо
vigneti - вигнети; en - вайгнити
tognana - тогнана; en - тогнейна
l'lle - ллле; en - ллл
serge - серге; en - сердж
merries air - мерриес аир; en - меррис аер
21 - 21; en - 21
thatchers - татчерс; en - сэтчерс
monnet - моннет; en - моннет
romanee-conti - романее-cонти; en - ромейни-конти
kladopoulou - кладопоулоу; fra - кладопулу
charpentron - чарпентрон; en - чэрпентрон
blanc du chateau - бланc ду чатеау; fra - бланк ду шато
di&di - ди&ди; en - ди&ди
castello di - cастелло ди; ita - кастелло ди
karmeliet - кармелиет; en - кэрмилит
tea - теа; en - ти
eco-max - эcо-макс; en - эко-мэкс
rcr - рcр; en - ркр
ecusson - эcуссон; en - экассон
dominio de - доминио де; fra - доминио де
wide - виде; ita - виде
quatre tours - кватре тоурс; fra - кватр турс
mediterranean - медитерранеан; en - мидитеррэнин
artzner - артзнер; ger - артцнер
jose - джосе; ita - жосе
pomato - помато; ita - помато
dickie - дикие; en - дикай
de may - де май; fra - де маи
brot - брот; en - брот
durso - дурсо; en - дерсо
macallan - маcаллан; en - мэколэн
de l'lle de - де ллле де; fra - де ллле де
australia - аустралиа; en - оастрейлиа
domaine marc colin - домаине марc cолин; en - домаин мэрк колин
yushi - йуши; en - юши
legend - легенд; en - ледженд
hauts - хауц; en - хоатс
burge - бурге; en - бердж
tudor - тудор; en - тьюдор
classe chateau - cлассе чатеау; fra - класс шато
eisele vineyard - еиселе винеярд; en - еизил виниярд
a slim - а слим; en - а слим
bartolini - бартолини; en - бэртолини
svetla - светла; en - светла
tours - тоурс; fra - турс
strongbow - стронгбов; en - стронгбоу
petrus - петрус; en - петрас
harp - харп; en - хэрп
gregorio - грегорио; en - григорио
gf - гф; en - гф
monange - монанге; en - монэндж
is - ис; en - ис
shop - шоп; en - шоп
closerie de - cлосерие де; fra - клозери де
maximin - максимин; en - мейксимин
domingo - доминго; en - доминго
huxol - хуксол; en - хьюксол
cases - cасес; en - кейзес
paradiso - парадисо; ita - парадисо
maree - марее; en - мейре
certified - cертифиед; en - сертифид
adega - адега; en - адига
klingenfus - клингенфус; en - клиндженфас
contents - cонтенц; en - контентс
festa - феста; en - феста
paras - парас; en - пейрэс
brio - брио; en - брио
momento - моменто; en - моменто
lambrays - ламбраис; en - лэмбрейс
casa coste - cаса cосте; ita - каса косте
around - ароунд; fra - арунд
asa - аса; en - аза
aquitaine - аквитаине; en - аквитаин
felicia - фелиcиа; en - филисиа
balvenie - балвение; en - бэлвенай
pepparrot - пеппаррот; en - пеппэррот
tatay - татай; en - тэтей
purina - пурина; ita - пурина
fida - фида; ita - фида
rosse - россе; ita - россе
moet & - моет &; en - моет &
moha - моха; ita - моха
scarnocchio - сcарноcчио; en - скэрнокчио
fabrice - фабриcе; en - фэбрис
mochi - мочи; en - мочи
amore - аморе; en - амор
skin - скин; en - скин
cooksmart - cооксмарт; en - куксмэрт
ronchi - рончи; en - рончи
comte georges de - cомте георгес де; fra - комт жеоржес де
la pizzuta - ла пиззута; ita - ла пиццута
salazar - салазар; en - сейлейзэр
forma - форма; en - форма
kitekat - китекат; en - китикэт
pain des - паин дес; en - паин дес
bulmers - булмерс; en - балмерс
duc - дуc; en - дак
skincare - скинcаре; en - скинкейр
sistema - система; en - систима
barbier - барбиер; en - бэрбир
melody - мелоди; en - милоди
meggle - меггле; en - меггл
tereza - тереза; ita - тереза
distell - дистелл; en - дистелл
caffe - cаффе; en - кэфф
sirene - сирене; ita - сирене
igor larionov - игор ларионов; en - игор лейрионов
bristot - бристот; en - бристот
colin-morey - cолин-морей; en - колин-мори
cardinal de - cардинал де; fra - кардинал де
liven - ливен; en - ливен
sapori di - сапори ди; ita - сапори ди
la chapelle de - ла чапелле де; fra - ла шапелле де
4use - 4усе; ita - 4усе
porta - порта; en - порта
tropical - тропиcал; en - тропикэл
ego de - эго де; fra - эго де
achaval-ferrer - ачавал-феррер; en - ачейвэл-феррер
mlekara - млекара; en - млекейра
haut-medoc de - хаут-медоc де; fra - хаут-медок де
shaving - шавинг; en - шейвинг
sarma - сарма; en - сэрма
parmonie - пармоние; en - пэрмонай
and - анд; en - анд
clarence dillon - cларенcе диллон; en - клейренс диллон
frantoio - франтоио; fra - франтуао
smith - смит; en - смис
bodegas jaume - бодегас джауме; en - бодигэс джоьюм
aquella - аквелла; fra - аквелла
agrochemie - агрочемие; en - агрочемай
beck - бек; en - бек
shary - шари; en - шейри
absolut - абсолут; en - абсолат
cheval - чевал; en - чивэл
puffeney - пуффеней; en - паффени
sangiorgio - сангиоргио; en - сэнджиорджио
bitouch - битоуч; fra - битуш
cardinal - cардинал; en - кэрдинэл
ginza - гинза; ger - гинза
cheetos - чеетос; en - читос
organia - органиа; en - оргейниа
subite - субите; ita - субите
palais - палаис; en - пейлаис
shokobutsu - шокобуцу; en - шокобатсу
chateau moulin - чатеау моулин; fra - шато мулин
franziskaner - франзисканер; ger - франзисканер
beghin - бегхин; en - бегхин
brocard domaine - броcард домаине; en - брокэрд домаин
tramier - трамиер; en - треймир
lanson - лансон; en - лэнсон
descendientes de jose - десcендиентес де джосе; fra - дескендиентес де жоз
al - ал; en - ал
olivier leflaive - оливиер лефлаиве; en - оливир лефлаив
calendreau - cалендреау; fra - календро
ecos - эcос; en - экос
chateau pichon-longueville - чатеау пичон-лонгуевилле; fra - шато пишон-лонгуевилле
houten - хоутен; fra - хутен
kitchen - китчен; en - китчен
beaute - беауте; fra - бот
carne - cарне; en - кэрн
afiche - афиче; en - афич
sogni - согни; en - согни
oma - ома; en - ома
tripel - трипел; en - трипел
bunzi - бунзи; ger - бунзи
coste - cосте; en - кост
raimbault - раимбаулт; en - раимбоалт
cosmetic - cосметиc; en - космитик
case - cасе; ita - касе
sairme - саирме; en - сэерм
nonino - нонино; ita - нонино
haiter - хаитер; en - хаитер
blanch - бланч; en - блэнч
deeside - деесиде; en - дизид
hi - хи; ita - хи
cascina - cасcина; en - кэссина
farme - фарме; en - фэрм
solis - солис; en - солис
hammerl - хаммерл; en - хэммерл
homare - хомаре; ita - хомаре
smacker - смакер; en - смэкер
gadais - гадаис; en - гейдаис
d'almerita - далмерита; en - дэлмирита
moloko - молоко; ita - молоко
herve - херве; en - херв
moueix - моуеикс; fra - муеикс
unicharm - уничарм; en - юничэрм
dewal - девал; en - дивэл
olivier - оливиер; en - оливир
freschello - фрешелло; ger - фрешелло
distillers - дистиллерс; en - дистиллерс
hokusetsu - хокусецу; en - хокьюзетсу
distilling - дистиллинг; en - дистиллинг
nature's - натурес; en - нэтерес
cemoi - cемои; en - симои
mata - мата; ita - мата
quatre - кватре; en - кватр
cookies - cоокиес; en - кукис
speed - спеед; en - спид
bagi/unicum - баги/униcум; en - бэджи/ьюникам
mehmet - мехмет; en - мехмет
gros - грос; en - грос
houx - хоукс; fra - хо
tomorrow`s - томорров`с; en - томорров`с
rambauds - рамбаудс; en - рэмбоадс
certan de may - cертан де май; fra - кертан де маи
souani - соуани; fra - суани
gartenz - гартенз; ger - гартенц
greece - грееcе; en - грис
brane-cantenac - бране-cантенаc; en - брейне-кэнтинэк
tenuta - тенута; ita - тенута
sauer - сауер; fra - сауер
berrisom - беррисом; en - берризом
gi meo - ги мео; ita - джи мео
qdo - кдо; en - кдо
organic - органиc; en - оргейник
les quatre tours - лес кватре тоурс; fra - ле кватр турс
princess - принcесс; en - принсесс
nemiroff - немирофф; en - немерофф
solar - солар; en - солэр
stax - стакс; en - стэкс
et - эт; en - эт
nagatoya - нагатоя; en - нейгейтоя
marini - марини; ita - марини
chungjungone - чунгджунгоне; en - чангджангон
haagen - хааген; en - хааджен
safe - сафе; ita - сафе
gotoff - готофф; en - готофф
special - спеcиал; en - списиол
firenze - фирензе; ger - фирензе
nikka - никка; en - никка
dommix - доммикс; en - доммикс
thai - таи; en - саи
chance - чанcе; fra - шанс
zlatea - златеа; en - злэти
flandres - фландрес; en - флэндрес
di gianfranco - ди гианфранcо; en - ди джианфрэнко
clinet - cлинет; en - клинет
famous - фамоус; fra - фамус
fattoria la - фатториа ла; ita - фатториа ла
delicia - делиcиа; en - дилисиа
agricola requingua - агриcола реквингуа; en - агрикола риквингуа
anton studio - антон студио; en - антон стьюдио
cj - cдж; en - кдж
gemene - гемене; ita - джемене
vegetable - вегетабле; en - веджитэбл
dentor - дентор; en - дентор
mitomo - митомо; ita - митомо
tignanello - тигнанелло; ita - тигнанелло
alain - алаин; en - алаин
belly - белли; en - белли
mortlach - мортлач; en - мортлэч
hortex - хортекс; en - хортекс
singleton - синглетон; en - синглитон
chips - чипс; en - чипс
mi@ko - ми@ко; en - ми@ко
compact - cомпаcт; en - компэкт
whittard - вхиттард; en - вхиттэрд
truefitt and - труефитт анд; en - трьюфитт анд
bud - буд; en - бад
lafitore - лафиторе; ita - лафиторе
lagraviere - лагравиере; en - лэгрейвир
gimonnet & - гимоннет &; en - джимоннет &
gancia - ганcиа; en - гэнсиа
famille - фамилле; ita - фамилле
casali - cасали; ita - касали
snack&fun - снак&фун; en - снэк&фан
chateau cheval - чатеау чевал; fra - шато шевал
champignon - чампигнон; en - чэмпайгнон
ltd - лтд; en - лтд
fragrance - фрагранcе; fra - фрагранс
d'amandier - дамандиер; en - деймэндир
marochip - марочип; en - мейрочип
tuilerie du - туилерие ду; fra - туилери ду
sales - салес; fra - салес
cantenac - cантенаc; en - кэнтинэк
glenmorangie - гленморангие; fra - гленморанж
perlax - перлакс; en - перлэкс
land - ланд; en - лэнд
manzanilla pasada - манзанилла пасада; ita - манцанилла пасада
ohe agrochemie - охе агрочемие; en - ох агрочемай
billecart-salmon - биллеcарт-салмон; en - билликэрт-сэлмон
lune - луне; ita - луне
costieres de - cостиерес де; fra - костиерес де
essence - эссенcе; ita - эссенче
chateau roc - чатеау роc; fra - шато рок
chatenet - чатенет; en - чейтинет
mechanical - мечаниcал; en - мечейникэл
domaine de la - домаине де ла; fra - домаин де ла
cloudy - cлоуди; fra - клуди
jens schleicher - дженс шлеичер; ger - енс шлейхер
ameri - амери; en - амири
feudi di - феуди ди; ita - фьюди ди
rigolade - риголаде; ita - риголаде
doppelherz - доппелхерз; ger - доппелхерц
domaine reine - домаине реине; en - домаин реин
dreamies - дреамиес; en - дримис
chenevieres - ченевиерес; en - чинивирес
grove - грове; en - гров
sa - са; ita - са
ohe - охе; en - ох
ecolovista - эcоловиста; en - эколовиста
pastora - пастора; en - пэстора
bakery - бакери; en - бейкири
asiago - асиаго; en - азиаго
box - бокс; en - бокс
jerry - джерри; en - джерри
akita - акита; en - акита
varvello - варвелло; ita - варвелло
bosca - босcа; en - боска
square oude - скваре оуде; en - сквар оьюд
piu - пиу; en - пиу
planters - плантерс; en - плэнтерс
mariangela - мариангела; en - мейрианджила
malony - малони; en - мейлони
pdc - пдc; en - пдк
vignerons de la - вигнеронс де ла; fra - вигнеронс де ла
bortolomiol - бортоломиол; en - бортоломиол
la sirene de - ла сирене де; fra - ла сирен де
vredenhof - вреденхоф; en - вриденхоф
gunderloch - гундерлоч; en - гандерлоч
brancaia - бранcаиа; fra - бранкаиа
vprove it's - впрове иц; en - впров итс
pizzuta del - пиззута дел; ger - пиззута дел
sairme mineral - саирме минерал; en - сэерм минирэл
argyle - аргиле; en - арджайл
meine - меине; en - меин
roland&amp - роланд&амп; en - ролэнд&эмп
branaire - бранаире; en - брейнэая
estelare - эстеларе; en - эстелейр
bodegas gerardo - бодегас герардо; en - бодигэс джирэрдо
canena - cанена; ita - канена
cantina - cантина; en - кэнтина
felinese - фелинесе; ita - фелинесе
pastinos - пастинос; en - пэстинос
kriek - криек; en - крик
coton - cотон; en - котон
tong - тонг; en - тонг
gottis - готтис; en - готтис
cosima - cосима; ita - косима
tissue - тиссуе; ita - тиссью
melima - мелима; ita - мелима
novas - новас; en - новэс
beyrie - беирие; en - беирай
sport - спорт; en - спорт
scottish fine - сcоттиш фине; en - скоттиш фин
beauty - беаути; fra - боти
losk - лоск; en - лоск
stewart - стеварт; en - стьюорт
valparaiso - валпараисо; en - вэлпейраизо
guzzini - гуззини; ita - гуццини
miror - мирор; en - мерор
llang - лланг; en - ллэнг
sailor jerry - саилор джерри; en - саилор джерри
magners - магнерс; en - мэгнерс
fullers - фуллерс; en - фаллерс
banan - банан; en - бейнэн
- center - cентер; en - сентер
lafleur-gazin - лафлеур-газин; fra - лафлеур-газин
owl - овл; en - овл
digo - диго; ita - диго
head & - хеад &; en - хид &
daeng gi meo - даенг ги мео; en - даенг джи ми
mugs - мугс; en - магс
morinaga - моринага; ita - моринага
montevertine - монтевертине; en - монтивертин
prats & - прац &; en - прэтс &
domaine de - домаине де; fra - домаин де
reisenthel - реисентел; en - реизензел
deonica - деониcа; en - диника
crisp - cрисп; en - крисп
shoulders - шоулдерс; en - шоулдерс
braida - браида; en - браида
royal selection - роял селеcтион; en - роиол силекшен
duralex - дуралекс; en - дерейлекс
yves - ивес; en - ивес
martray - мартрай; en - мэртрей
igor - игор; en - игор
eliris - элирис; en - элерис
vik's - викс; en - викс
misura - мисура; ita - мисура
note - ноте; ita - ноте
blue hills - блуе хиллс; en - блу хиллс
konjak - конджак; en - конджэк
queen - квеен; fra - квеен
pets - пец; en - петс
serie - серие; en - серай
isola dei - исола деи; en - изола деи
sgambaro - сгамбаро; en - сгэмбейро
dicora - диcора; ita - дикора
ghidini - гхидини; en - гхидини
teamore - теаморе; en - тимор
tutto - тутто; ita - тутто
ri - ри; ita - ри
jacques - джаcквес; fra - жакквес
villmonte - виллмонте; en - виллмонт
fine soaps - фине соапс; ita - фине соапс
pierre-luc - пиерре-луc; ita - пиерре-лук
eric - эриc; en - эрик
giacosa - гиаcоса; en - джиакоза
rosazza - росазза; ita - росацца
whiskey - вхискей; en - вхиски
kou - коу; fra - ку
kremlin - кремлин; en - кремлин
torino - торино; ita - торино
robin - робин; en - робин
ovisolio - овисолио; en - овизолио
baby project - баби проджеcт; en - бейби проджект
hanhui - ханхуи; en - хэнхуи
fabrica - фабриcа; en - фэбрика
glen - глен; en - глен
linck - линк; en - линк
littlest - литтлест; en - литтлест
horses - хорсес; en - хорсес
chevalier - чевалиер; en - чевейлир
d'esclans - десcланс; en - десклэнс
