raw_word;naive_trans;spec_trans;
gardens - гарденс; en - гарденс
niero - ниеро; en - ниро
d'aydie - даидие; fra - дейди
frabosk - фрабоск; en - фрейбоск
lermont - лермонт; en - лермонт
sensitive - сенситиве; en - сенситив
sfoglia - сфоглиа; en - сфоглиа
llopart - ллопарт; en - ллопарт
gaffeliere - гаффелиере; en - гаффелььер
messori - мессори; ita - мессори
grandma - грандма; en - грандма
selosse - селоссе; ita - селоссе
domaine armand - домаине арманд; en - домейн арманд
staropramen - старопрамен; en - стейропреймен
desir - десир; en - дезир
rouge du chateau - роуге ду чатеау; fra - руж ду шато
alimentari - алиментари; en - алиментейри
lea - леа; en - льи
monbousquet - монбоусквет; fra - монбусквет
carillon de - cариллон де; fra - кариллон де
bellingham insignia - беллингхам инсигниа; fra - беллингам инсигниа
pasionado - пасионадо; en - пейзионейдо
anna lafarg - анна лафарг; en - анна лейфарг
plum - плум; en - плюм
membrillo - мембрилло; en - мембрилло
grizzly - гриззли; en - гриззли
cucumis - cуcумис; ita - кукумис
angel - ангел; en - энджел
chantovent - чантовент; en - чантовент
shuzojo - шузоджо; jap - шузоджо
valescure vignobles - валескуре вигноблес; fra - валескур вигноблес
create - cреате; en - крит
legend of - легенд оф; en - ледженд оф
symphonia bee - симфониа бее; en - симфониа бе
vernoilaise - верноилаисе; en - верноилейз
avecmoi - авеcмои; en - авекмои
l'atelier - лателиер; fra - лательер
schrodel - шродел; ger - шродел
ott* - отт; en - отт
chateau clerc - чатеау cлерc; fra - шато клерк
guru - гуру; ita - гуру
grand-puy-lacoste - гранд-пуи-лаcосте; fra - гранд-пуи-лакост
moeka - моека; en - моека
elis - элис; en - элис
casale - cасале; en - кейзейл
corine - cорине; en - корин
gym pasta young - гим паста йоунг; en - джим паста юнг
chateau la - чатеау ла; fra - шато ла
mouline - моулине; fra - мулин
domaine la taille - домаине ла таилле; ita - домайне ла таилле
penotti - пенотти; ita - пенотти
vine - вине; en - вин
chodovar - чодовар; en - чодовар
the scottish - те скоттиш; en - зе скоттиш
roquebrun - роквебрун; fra - роквебрун
felluga - феллуга; ita - феллуга
chamore - чаморе; en - чеймор
dopdrops - допдропс; en - допдропс
honey - хоней; en - хоней
sunsmile - сунсмиле; en - сансмил
heerengracht - хееренграчт; ger - хееренграхт
brushes - брушес; en - брашес
kochstar - кочстар; ger - кохстар
robert - роберт; en - роберт
d'arques - дарквес; fra - дарквес
feast - феаст; en - фист
chefs - чефс; en - чефс
kwak - квак; en - квак
qegg - кегг; en - кегг
provencal - провенcал; en - провенкал
schiefer - шиефер; ger - шифер
quinta - квинта; en - квинта
mela - мела; jap - мела
purdey's - пурдеис; en - пардейс
black label - блак лабел; en - блэк лейбел
beatrix - беатрих; en - битрикс
pick - пик; en - пик
goods - гоодс; en - гудс
d'estournel - дестоурнел; fra - дестурнел
titbit - титбит; en - титбит
pellehaut harmonie de - пеллехаут хармоние де; fra - пеллехаут хармони де
baudry - баудри; en - бодри
ottosoldi - оттосолди; ita - оттосольди
dab - даб; en - даб
globster - глобстер; ger - глобштер
arm - арм; en - арм
biopractika - биопраcтика; en - биопрактика
003 - 003; ger - 003
auchentoshan - аучентошан; ger - аухентошан
cefiro - cефиро; en - сефиро
bruichladdich - бруичладдич; ger - бруихладдих
the chemical - те чемиcал; en - зе чемикал
hollender - холлендер; en - холлендер
kulmbacher - кулмбачер; en - кальмбачер
interlock - интерлок; en - интерлок
altero - алтеро; en - альтеро
hollandia - холландиа; ita - холландиа
veroni - верони; en - верони
coleccion - cолеccион; ita - колеччион
uni - уни; en - юни
osteria - остериа; en - остериа
spiegelau - спиегелау; en - спиджельо
primo - примо; en - примо
red - ред; en - ред
bon - бон; en - бон
pichon longueville - пичон лонгуевилле; en - пичон лонгвилл
domaine de pellehaut - домаине де пеллехаут; fra - домаин де пеллехаут
blanch de - бланч де; ger - бланх де
cardhu - cардху; en - карда
grill - грилл; en - грилл
hans - ханс; en - ханс
dairy - даири; en - дэйри
wai - ваи; en - вей
il gusto - ил густо; en - ил гасто
romano - романо; ita - романо
gruntaler - грунталер; en - грантейлер
pril - прил; en - прил
chateau pape - чатеау папе; fra - шато пап
danish - даниш; en - дейниш
acetaia - аcетаиа; fra - акетаиа
silko - силко; en - силько
tarlant - тарлант; en - тарлант
may de - май де; fra - маи де
heineken - хеинекен; ger - хейнекен
riecine - риеcине; en - рисин
edradour - эдрадоур; fra - эдрадур
scottish fine soaps - скоттиш фине соапс; en - скоттиш фин соапс
gemischter - гемиштер; ger - гемиштер
shelim - шелим; en - шелим
arla - арла; en - арла
atkins & - аткинс анд; en - аткинс энд
porcelaine czech - порcелаине cзеч; en - порселейн чех
pontet - понтет; en - понтет
horny - хорни; en - хорни
nocciolata - ноccиолата; ita - ноччиолата
carmani - cармани; en - кармейни
snackars - снакарс; en - снакарс
frozen - фрозен; en - фрозен
vinhos - винхос; en - винхос
xenta - хента; en - ксента
liebe - лиебе; en - либ
cheese - чеесе; en - чиз
stay - стай; en - стей
chikao - чикао; en - чикао
damm - дамм; en - дамм
domaine antonin - домаине антонин; en - домейн антонин
lab. - лаб; en - лаб
abuelo - абуело; en - абюело
chateau pavie - чатеау павие; fra - шато пави
ladelle - ладелле; ita - ладелле
lamour - ламоур; fra - ламур
warsteiner - варстеинер; ger - варштейнер
qia - киа; en - киа
pasticcere - пастиccере; ita - пастиччере
bodegas palacios - бодегас палаcиос; en - бодегас пейлейсиос
cartron - cартрон; en - картрон
banana - банана; ita - банана
nordqvist - нордквист; ger - нордкфишт
bouchaud le - боучауд ле; fra - бушауд ле
citran - cитран; en - ситран
sana - сана; ita - сана
crunchy - cрунчи; en - кранчи
williams - виллиамс; en - виллиамс
riverlore - риверлоре; en - риверлор
manuoki - мануоки; en - менюоки
jean-marc brocard - джеан-марc броcард; en - джин-марк брокард
tart - тарт; en - тарт
han - хан; en - хан
palm - палм; en - пальм
d'orfeuilles - дорфеуиллес; fra - дорфеуиллес
softymo mineral - софтимо минерал; en - софтаймо минерал
distillery - дистиллери; en - дистиллери
simonini - симонини; ita - симонини
honke - хонке; en - хонк
hakushika tatsuuma - хакушика татсуума; jap - хакушика тацума
wagon - вагон; en - вейгон
ballarini - балларини; ita - балларини
lequin-colin - леквин-cолин; en - леквин-колин
chateau tour des - чатеау тоур дес; fra - шато тур дес
landron - ландрон; en - ландрон
france - франcе; fra - франс
juliette - джулиетте; ita - жулиетте
manuka - манука; ita - манука
nature s - натуре с; en - начур с
choya - чоя; en - чойа
quinta do - квинта до; ita - квинта до
trixie - трихие; en - трикси
allende - алленде; ita - алленде
romans - романс; en - романс
gusto della - густо делла; ita - густо делла
ardi - арди; en - арди
harmonie - хармоние; en - хармони
culemborg - cулемборг; en - кюлемборг
multiplus - мултиплус; en - мальтиплас
riegele - риегеле; en - риджел
cauhape - cаухапе; en - кохейп
l'angelus - лангелус; fra - ланжелюс
folke - фолке; en - фольк
glenglassaugh - гленглассаугх; en - гленглассо
francaise - франcаисе; en - франкейз
delray beach - делрай беач; en - дельрей бич
thomas foods - томас фоодс; en - сомас фудс
mancin - манcин; en - менсин
regal - регал; en - регал
labo - лабо; ita - лабо
a'pieu - апиеу; fra - апьеу
bellingham - беллингхам; fra - беллингам
renu - рену; jap - рену
ode - оде; en - од
graham - грахам; en - грейхам
veltins - велтинс; en - вельтинс
nepenthe - непенте; en - непенз
silampos - силампос; en - силампос
little - литтле; en - литтл
granto - гранто; en - гранто
vacu - ваcу; ita - ваку
nobby - нобби; en - нобби
sinnack - синнак; en - синнак
diablo - диабло; en - диабло
fad - фад; en - фад
kandylas - кандилас; en - кандайлас
cesar - cесар; en - сезар
long - лонг; en - лонг
francaise de - франcаисе де; fra - франкаиз де
black angus - - блак ангус; en - блэк ангас
piano - пиано; en - пиано
d'alibert - далиберт; fra - далиберт
tour des - тоур дес; fra - тур дес
zipfer - зипфер; en - зипфер
branaire-ducru - бранаире-дуcру; en - бранаирдакра
fernet - фернет; en - фернет
halal - халал; en - хейлал
salzburg - салзбург; ger - залцбург
sunny - сунни; en - санни
farmstay - фармстай; en - фармстей
toscana - тоскана; en - тоскейна
winkler - винклер; en - винклер
pedesclaux - педесклаух; fra - педесклаукс
smoca - смоcа; en - смока
vin - вин; en - вин
carillon - cариллон; en - кейриллон
jti co - джти cо; ita - жти ко
punica - пуниcа; ita - пуника
l'arlot - ларлот; fra - ларлот
matusalem - матусалем; en - матюзейлем
rendez - рендез; en - рендез
schleicher - шлеичер; ger - шлейхер
la tuilerie - ла туилерие; ita - ла туйлерие
haut bages - хаут багес; en - хот баджес
fujiya - фуджия; jap - фуджия
vignoble - вигнобле; en - вигнобл
bodegas hermanos - бодегас херманос; en - бодегас хермейнос
capo di - cапо ди; ita - капо ди
etude - этуде; en - этюд
flamigni - фламигни; en - флеймигни
nutrition - нутритион; en - натришен
artsakh - артсакх; en - арцакх
bodegas y vinedos - бодегас и винедос; en - бодегас й винедос
simplyrow - симплиров; en - симплайроу
pet - пет; en - пет
men expert skin - мен эхперт скин; en - мен эксперт скин
naturaverde - натураверде; en - натюрейверд
miolla - миолла; ita - миолла
domeine - домеине; en - домеин
bio-max - био-мах; en - био-макс
concentrate - cонcентрате; en - консентрейт
name - наме; en - нейм
weil - веил; en - веил
anwilka - анвилка; en - анвилька
apagard - апагард; en - апейгард
atlantico - атлантиcо; en - атлантико
botanical - ботаниcал; en - ботейникал
courvoisier - cоурвоисиер; fra - курвуазьер
pads - падс; en - падс
voh - вох; en - вох
naturprodukte - натурпродукте; en - нейтарпродакт
marquesa - марквеса; fra - марквеза
retreat - ретреат; en - ретрит
prieur-brunet - приеур-брунет; fra - прьеур-брунет
shaker - шакер; en - шейкер
atkins - аткинс; en - аткинс
leiner - леинер; en - леинер
l'lle de - ллле де; fra - ллле де
grade - граде; en - грейд
fish - фиш; en - фиш
noire - ноире; en - ноаир
d'issan - диссан; fra - диссан
les ormes - лес ормес; fra - ле ормес
botavikos - ботавикос; en - ботейвикос
stiegl - стиегл; en - стигл
chinaware - чинаваре; en - чиновор
spreewald - спреевалд; en - спреьюальд
sucre - суcре; en - сакр
martell - мартелл; en - мартелл
berio - берио; en - берио
perrier-jouet - перриер-джоует; fra - перрьер-жует
campos - cампос; en - кампос
johnny's chop - джохннис чоп; en - джохннис чоп
appetite - аппетите; ita - аппетите
o'hara's - охарас; en - охейрас
belgian - белгиан; en - бельджиан
pere et - пере эт; en - пер эт
blanc - бланc; en - бланк
beckmann - бекманн; ger - бекманн
moutard - моутард; fra - мутард
issan - иссан; en - иссан
petreet - петреет; en - петрит
chanoine - чаноине; en - чейноин
shanghai chikao - шангхаи чикао; en - шангей чикао
domeine la - домеине ла; ita - домейне ла
gravaillas - граваиллас; en - грейвейллас
bonny - бонни; en - бонни
di san - ди сан; ita - ди сан
knappogue - кнаппогуе; ita - кнаппогью
adega cooperativa - адега cооператива; en - адега куперейтива
les jardins - лес джардинс; fra - ле жардинс
domaine amiot - домаине амиот; en - домейн амиот
lanessan - ланессан; en - лейнессан
bozita - бозита; ita - бозита
all natural - алл натурал; en - ол начюрал
vodopivec - водопивеc; en - водопивек
rechtenbacher - речтенбачер; ger - рехтенбахер
gisele - гиселе; en - джизел
megami - мегами; jap - мегами
solaire - солаире; en - сольаир
madia - мадиа; en - мейдиа
don - дон; en - дон
roberto - роберто; en - роберто
chacra - чаcра; en - чакра
doyac - дояc; en - дойак
eesti - еести; en - исти
carne de - cарне де; fra - карн де
efes - эфес; en - эфес
poderi - подери; jap - подери
lord - лорд; en - лорд
jameson - джамесон; en - джеймезон
trawa - трава; en - трова
chateau grand corbin - чатеау гранд cорбин; fra - шато гранд корбин
lactoferrin - лаcтоферрин; en - лактоферрин
swirl - свирл; en - свирл
stor - стор; en - стор
hosten - хостен; en - хостен
square - скваре; en - сквейр
steripan - стерипан; en - стерипан
nakatomi - накатоми; ita - накатоми
italia in - италиа ин; en - итейлиа ин
reali - реали; en - реали
show - шов; en - шоу
grands houx - грандс хоух; fra - грандс хо
nestogen - нестоген; en - нестоджен
europol - еуропол; fra - европол
bellegrave - беллеграве; ita - беллеграве
feedback - феедбак; en - фидбак
goldfish - голдфиш; en - гольдфиш
levrana - леврана; en - леврейна
razors - разорс; en - рейзорс
les hauts - лес хаутс; fra - ле хаутс
fresca - фреска; en - фреска
bodegas campos - бодегас cампос; en - бодегас кампос
quickpack - квикпак; en - квикпак
kahlua - кахлуа; en - кахлюа
tero eco - теро эcо; en - теро эко
lsa - лса; en - льса
de may de - де май де; fra - де маи де
mort - морт; en - морт
kose softymo - косе софтимо; en - коз софтаймо
comte de - cомте де; fra - комт де
barone - бароне; en - бейрон
aurel - аурел; en - орел
laffitte-teston - лаффитте-тестон; ita - лаффитте-тестон
teacher's - теачерс; ger - теахерс
czech - cзеч; en - чех
case basse di - cасе бассе ди; ita - касе бассе ди
lacapelle - лаcапелле; ita - лакапелле
sparina - спарина; en - спейрина
clos - cлос; en - клос
softymo - софтимо; en - софтаймо
magnien - магниен; en - магнин
vinedos - винедос; en - винедос
serre - серре; ita - серре
happy - хаппи; en - хаппи
michel - мичел; en - мичел
chateau cos - чатеау cос; fra - шато кос
4uze - 4узе; en - 4юз
great - греат; en - грит
sichel - сичел; en - сичел
vineyard estate - винеярд эстате; en - винейард эстейт
jean de - джеан де; fra - жеан де
laurenz - лауренз; en - льоренз
cream - cреам; en - крим
perle - перле; en - перл
tai - таи; en - тей
kim - ким; en - ким
pomerols - померолс; en - померольс
ola - ола; en - ола
taille - таилле; ita - таилле
leroy - лерой; en - лерой
viticultori - витиcултори; en - витикальтори
coco - cоcо; ita - коко
export - эхпорт; en - экспорт
sainte-claire - саинте-cлаире; en - сейнте-кльаир
d'eugenie - деугение; fra - деужени
poderi aldo - подери алдо; en - подери альдо
signature - сигнатуре; en - сигначур
gym pasta - гим паста; en - джим паста
zacapa - заcапа; ita - закапа
& the - анд те; en - энд зе
ruffoni - руффони; en - раффони
fit-fit - фит-фит; en - фит-фит
d'orignac - доригнаc; fra - доригнак
home of - хоме оф; en - хом оф
domaine thierry et - домаине тиерри эт; en - домейн зиерри эт
fiorella - фиорелла; ita - фиорелла
baron philippe - барон филиппе; en - бейрон филипп
malpighi - малпигхи; en - мальпиги
bcl - бcл; ger - бкл
pellehaut - пеллехаут; en - пеллехот
adrenaline - адреналине; en - адренейлин
chin-su - чин-су; en - чин-са
all - алл; en - ол
domaine le - домаине ле; fra - домаин ле
dana - дана; ita - дана
les vignerons - лес вигнеронс; fra - ле вигнеронс
pinopasso - пинопассо; ita - пинопассо
xd design bobby - хд десигн бобби; en - ксд дезигн бобби
kaapse rooi oude - каапсе роои оуде; fra - каапс роуа уд
derma - дерма; en - дерма
ideshigyo - идешигио; en - идешиджио
farm - фарм; en - фарм
chateau beau - чатеау беау; fra - шато бо
wine - вине; en - вин
roses - росес; en - розес
crinan - cринан; en - кринан
alghero - алгхеро; en - альгеро
greenfield - греенфиелд; en - гринфильд
reales - реалес; fra - реалес
chandon - чандон; en - чандон
noodles - ноодлес; fra - ноодлес
gordon's - гордонс; ger - гордонс
celebrate - cелебрате; en - селебрейт
alpasion - алпасион; en - альпасен
bonne - бонне; en - бонн
campanaro - cампанаро; en - кампейнейро
chai - чаи; en - чей
pol-mak - пол-мак; en - пол-мак
chateau le - чатеау ле; fra - шато ле
sensei la maison - сенсеи ла маисон; ita - сенсеи ла майсон
bio-oil - био-оил; en - био-оил
eunyul - еуниул; en - евниул
georges - георгес; en - джирджес
australian - аустралиан; en - острейлиан
jigott - джиготт; en - джиготт
zooexpress - зооехпресс; fra - зооекспресс
zot - зот; en - зот
tsingtao - тсингтао; en - цингтао
umenishiki - уменишики; jap - уменишики
valdueza - валдуеза; en - вальдюеза
grand cru - гранд cру; en - гранд кра
vinturi - винтури; en - винтюри
du chateau - ду чатеау; fra - ду шато
david - давид; en - дейвид
west - вест; en - вест
suntory - сунтори; en - сантори
borie - борие; en - бори
nothing - нотинг; en - нозинг
weingut reichsgraf - веингут реичсграф; ger - вейнгут рейхсграф
tac - таc; en - так
visciano - вискиано; en - виссиано
potter - поттер; en - поттер
moro - моро; ita - моро
quantum - квантум; en - квантам
drambuie - драмбуие; fra - драмбуи
deep - дееп; en - дип
domaine bruno - домаине бруно; en - домейн брюно
moremo - моремо; jap - моремо
pezzetti - пеззетти; ita - пеццетти
neil - неил; en - неил
cillit - cиллит; en - силлит
monasterio - монастерио; en - монастерио
ora2 - ора2; en - ора2
lemon - лемон; en - лемон
boulard - боулард; fra - булард
clair - cлаир; en - кльэйр
piron - пирон; en - пирон
la porta - ла порта; ita - ла порта
fond - фонд; en - фонд
kozel - козел; en - козел
marinex - маринех; en - мейринекс
cab prime - cаб приме; en - каб прим
suduiraut - судуираут; en - сюдюирот
brisson - бриссон; en - бриссон
dgj - дгдж; ger - дгй
pearl river - пеарл ривер; en - пирл ривер
ceretto - cеретто; ita - черетто
garzon-maldonado - гарзон-малдонадо; en - гарзон-мальдонейдо
serristori - серристори; ita - серристори
baron philippe de - барон филиппе де; fra - барон филипп де
shanghai - шангхаи; en - шангей
eins zwei - еинс звеи; en - еинс звеи
brandi - бранди; en - бранди
alldays - аллдаис; en - олдейс
soy - сой; en - сой
finest - финест; en - финест
grondard - грондард; en - грондард
ivv - ивв; en - ивв
haus - хаус; en - хос
fass - фасс; en - фасс
domaine les grands - домаине лес грандс; ger - домаине лес грандс
zecca - зеccа; ita - зецца
gemma - гемма; en - джемма
traquair - тракваир; fra - тракваир
clicquot - cлиcквот; en - кликквот
napla - напла; en - напла
teston - тестон; en - тестон
domaine hubert - домаине хуберт; en - домейн хюберт
miraflores - мирафлорес; en - мирафлорес
san giuliano - сан гиулиано; en - сан джиулиано
minimax - минимах; en - минимакс
spelta - спелта; en - спельта
l'eglis - леглис; fra - леглис
catalan - cаталан; en - кейтейлан
male - мале; en - мейл
gnarly - гнарли; en - гнарли
ishihara - ишихара; en - ишихейра
mere - мере; en - мер
thailand - таиланд; en - сейланд
caliterra - cалитерра; ita - калитерра
pagar - пагар; en - пейгар
bacardi - баcарди; en - бейкарди
giusti - гиусти; en - джиусти
esprit de - эсприт де; fra - эсприт де
phelps - фелпс; ger - фелпс
butter - буттер; en - баттер
cadillac - cадиллаc; en - кейдиллак
naty - нати; en - нейти
backerei - бакереи; en - бакереи
laville - лавилле; ita - лавилле
reichsgraf - реичсграф; ger - рейхсграф
peeps - пеепс; en - пипс
england - энгланд; en - ингланд
ivv every - ивв эвери; en - ивв эвери
tai chinaware - таи чинаваре; en - тей чиновор
les hauts de - лес хаутс де; fra - ле хаутс де
dillon - диллон; en - диллон
jetbottle - джетботтле; en - джетботтл
rocheyron - рочеирон; en - рочейрон
fontarney - фонтарней; en - фонтарней
batiste - батисте; en - бейтист
compagnie - cомпагние; fra - компайн
soaps - соапс; en - соапс
errazuriz - эрразуриз; en - эрразюриз
gals - галс; en - гальс
create your monster - cреате йоур монстер; en - крит ер монстер
angry - ангри; en - ангри
loubaney - лоубаней; fra - лубанеи
lebrun - лебрун; en - лебран
gertrude - гертруде; en - джертрюд
vplab - вплаб; en - вплаб
balance - баланcе; fra - баланс
deveron - деверон; en - деверон
amiot guy - амиот гуй; en - амиот гюи
beam - беам; en - бим
in a - ин а; en - ин а
mosconi - москони; en - москони
taillade - таилладе; ita - таилладе
design bobby - десигн бобби; en - дезигн бобби
oat - оат; en - оат
sublime - сублиме; en - саблим
l'atelier du - лателиер ду; fra - лательер ду
chamcalet - чамcалет; en - чамкейлет
tampax - тампах; en - тампакс
three - трее; en - сре
arboleda - арболеда; en - арболеда
buis - буис; en - бюис
diar - диар; en - диар
bandarossa - бандаросса; ita - бандаросса
bellingham insignia serie - беллингхам инсигниа серие; fra - беллингам инсигниа сери
belveder - белведер; en - бельведер
dal - дал; en - дал
jamie - джамие; en - джейми
alce - алcе; en - альс
stronachie - строначие; en - строначи
men - мен; en - мен
fiorente - фиоренте; en - фиорент
gerardo - герардо; en - джерардо
veuve - веуве; en - вьюв
larionov select - ларионов селеcт; en - лейрионов селект
siberica - сибериcа; en - сиберика
voloute - волоуте; fra - волут
bubbies - буббиес; en - баббис
marbelle - марбелле; ita - марбелле
le perd - ле перд; fra - ле перд
polje - полдже; en - польдж
jurassic - джурассиc; en - джюрассик
banfi - банфи; en - банфи
konitz - конитз; en - конитз
d`aurilhac - даурилхаc; en - дорильхак
caldora - cалдора; en - кальдора
cantine - cантине; en - кантин
zlato - злато; en - злейто
pate - пате; en - пейт
jens - дженс; en - дженс
corinto - cоринто; en - коринто
thierry et - тиерри эт; en - зиерри эт
chapelle - чапелле; ita - капелле
chateau la croix - чатеау ла cроих; fra - шато ла круа
wax - вах; en - вакс
rouge du - роуге ду; fra - руж ду
marmaluzi - мармалузи; en - мармалюзи
procomfort - проcомфорт; en - прокомфорт
private - привате; en - привейт
lattesso - латтессо; ita - латтессо
horst - хорст; ger - хоршт
familia deicas - фамилиа деиcас; en - феймилиа деикас
barde-haut - барде-хаут; en - барде-хот
sensei la - сенсеи ла; ita - сенсеи ла
maison du - маисон ду; fra - маизон ду
siaurac - сиаураc; fra - сиаурак
bonsai - бонсаи; en - бонсей
chateau phelan - чатеау фелан; fra - шато фелан
antico molino - антиcо молино; ita - антико молино
mont'arquato - монтарквато; en - монтарквейто
domaine yves - домаине ивес; en - домейн йвес
compania - cомпаниа; en - компейниа
distillerie - дистиллерие; ita - дистиллерие
cellar - cеллар; en - селлар
head - хеад; en - хид
milla halal - милла халал; ita - милла халаль
glenrothes - гленротес; en - гленрозес
porta di - порта ди; ita - порта ди
aloins - алоинс; en - алоинс
serra - серра; ita - серра
r.a.w.life - равлифе; en - ровлиф
health - хеалт; ger - хеалтх
sohni-wicke - сохни-вике; en - сохни-вик
marquesa de - марквеса де; fra - марквеза де
chateau la tuilerie - чатеау ла туилерие; fra - шато ла туилери
ecover - эcовер; en - эковер
corporation - cорпоратион; en - корпорашен
bouey - боуей; fra - буеи
hennessy - хеннесси; en - хеннесси
andre's - андрес; en - андрес
frau - фрау; en - фро
birra - бирра; ita - бирра
azzuro - аззуро; ita - аццуро
teta - тета; jap - тета
teeny - теени; en - тини
isme - исме; en - исм
vina - вина; ita - вина
freunde - фреунде; en - фрьюнд
1st - 1ст; ger - 1шт
raison - раисон; en - рейзон
kosta - коста; en - коста
guir - гуир; en - гюир
grand-mere - гранд-мере; en - гранд-мер
cantemerle - cантемерле; en - кантемерл
lagoon - лагоон; en - лейгун
alnardo - алнардо; en - альнардо
pomi - поми; ita - поми
bodegas horacio - бодегас хораcио; en - бодегас хорейсио
heidi - хеиди; en - хеиди
yaokin - яокин; en - йаокин
maro'schip43 - марошип43; ger - марошип43
fairview - фаирвиев; en - фэйрвив
ashmead - ашмеад; en - ашмид
rothschild - ротшилд; ger - ротхшилд
hoegaarden - хоегаарден; en - хоегаарден
shur - шур; en - шар
wings - вингс; ger - вингс
imball - имбалл; en - имболл
l'oreal skin - лореал скин; fra - лореал скин
jump energy - джумп энерги; en - джамп энерджи
eley - элей; en - элей
dagueneau & - дагуенеау анд; fra - дагуено анд
leoville - леовилле; ita - леовилле
vecchio - веcчио; en - векчио
eisele vineyard estate - еиселе винеярд эстате; en - еизел винейард эстейт
amstel - амстел; ger - амштел
familia - фамилиа; en - феймилиа
l'or - лор; fra - лор
adriona - адриона; en - адриона
china plum - чина плум; en - чина плюм
mepsi - мепси; en - мепси
ulysse - улиссе; ita - улиссе
estelare institute - эстеларе институте; ger - эштеларе инштитуте
traditional messori - традитионал мессори; en - трейдишенал мессори
americo - америcо; en - америко
hacker-pschorr - хакер-пшорр; ger - хакер-пшорр
grolsch - гролш; ger - гролш
foods - фоодс; en - фудс
descendientes - дескендиентес; en - дессендинтес
warmies - вармиес; en - вормис
boddingtons - боддингтонс; en - боддингтонс
larionov - ларионов; en - лейрионов
similac - симилаc; en - симилак
lafarg - лафарг; en - лейфарг
wellery - веллери; en - веллери
chillafish bunzi - чиллафиш бунзи; ger - киллафиш бунзи
top - топ; en - топ
vega del - вега дел; en - вега дел
vaily - ваили; en - вейли
domini - домини; ita - домини
porcelaine czech gold - порcелаине cзеч голд; en - порселейн чех гольд
big - биг; en - биг
nanoprotech - нанопротеч; en - нейнопротеч
czech gold - cзеч голд; en - чех гольд
myron - мирон; en - майрон
kiwi - киви; jap - киви
soroci - сороcи; ita - сорочи
rodez - родез; en - родез
ode to - оде то; ita - оде то
supermario - супермарио; en - супермейрио
les grands houx - лес грандс хоух; fra - ле грандс хо
gasnier - гасниер; en - гаснир
tero - теро; jap - теро
town - товн; en - тоун
soft - софт; en - софт
rivers - риверс; en - риверс
lagavulin - лагавулин; en - лейгавюлин
face - фаcе; en - фейс
marques de - марквес де; fra - марквес де
treatment - треатмент; en - тритмент
isobel - исобел; en - изобел
agricola san - агриcола сан; en - агрикола сан
cup - cуп; en - кап
d'anjou - данджоу; fra - данжу
beef.on - беефон; en - бифон
marchesi - марчеси; en - марчези
domaine georges - домаине георгес; en - домейн джирджес
hero - херо; jap - херо
potensac - потенсаc; en - потенсак
pasta del - паста дел; en - паста дел
boulangere - боулангере; fra - буланжер
mat&lou - мат анд лоу; fra - мат анд лу
hillway - хиллвай; en - хиллвей
berlinger - берлингер; en - берлинджер
clear - cлеар; en - кльир
cristoforo - cристофоро; en - кристофоро
aqa - ака; en - ака
expertise - эхпертисе; en - экспертиз
wolpertinger - волпертингер; en - вольпертинджер
snack - снак; en - снак
blanc du - бланc ду; fra - бланк ду
founders - фоундерс; fra - фундерс
castillo de - cастилло де; ita - кастилло де
kendermann - кендерманн; ger - кендерманн
almaviva - алмавива; en - альмейвива
cereals - cереалс; en - серильс
cow - cов; en - коу
smartwater - смартватер; en - смартвейтер
anselmi - анселми; en - ансельми
las - лас; en - лас
original - оригинал; en - ориджинал
munchkin - мунчкин; ger - мунхкин
reyka - реика; en - рейка
ritinitis - ритинитис; en - ритинитис
mondoro - мондоро; en - мондоро
sheridan's - шериданс; ger - шериданс
trest - трест; en - трест
cru - cру; en - кра
lunaris - лунарис; en - люнейрис
gefu - гефу; jap - гефу
juicy - джуиcи; en - джюиси
newcastle - невcастле; en - ньюкастл
felice - фелиcе; en - фельайс
xl-s - хл-с; en - ксл-с
margaux - маргаух; fra - маргаукс
luxplast - лухпласт; en - лакспласт
des deux - дес деух; fra - дес деукс
living - ливинг; en - ливинг
elisabeth - элисабет; en - элизейбес
podere - подере; en - подер
siciliana - сиcилиана; en - сисилиана
ferme - ферме; en - ферм
orihiro - орихиро; en - орихиро
nissan - ниссан; en - ниссан
cornetto - cорнетто; ita - корнетто
hill's - хиллс; ger - хиллс
bouchard pere & - боучард пере анд; fra - бушард пер анд
kurt - курт; en - карт
kesper - кеспер; en - кеспер
d`orfeuilles - дорфеуиллес; fra - дорфеуиллес
angus - ангус; en - ангас
gaitero - гаитеро; en - гейтеро
gartenz de - гартенз де; fra - гартенц де
fourcas-borie - фоурcас-борие; fra - фуркас-бори
chateau certan de - чатеау cертан де; fra - шато кертан де
gouges - гоугес; fra - гужс
pellehaut harmonie - пеллехаут хармоние; en - пеллехот хармони
miyoshi - мииоши; jap - миеши
cecu - cеcу; ita - чеку
walsh - валш; ger - валш
daler - далер; en - дейлер
calabria family - cалабриа фамили; en - кейлабриа феймили
greengate - греенгате; en - грингейт
gras - грас; en - грас
domaine de valescure - домаине де валескуре; fra - домаин де валескур
strock brot - строк брот; en - строк брот
eco - эcо; en - эко
tiger - тигер; en - тиджер
strock - строк; en - строк
montrose - монтросе; en - монтроз
solan - солан; en - солан
kitchen&love - китчен анд лове; en - китчен энд лов
barade - бараде; en - бейрейд
frapin - фрапин; en - фрейпин
parastone - парастоне; en - пейрастон
british - бритиш; en - бритиш
gazin - газин; en - гейзин
atiza - атиза; en - атиза
miracle - мираcле; en - миракл
everyday - эверидай; en - эверидей
mann - манн; ger - манн
gatsby - гатсби; en - гацби
1862 - 1862; ger - 1862
zwilling - звиллинг; en - звиллинг
bongo - бонго; en - бонго
touque - тоукве; fra - тук
bridge - бридге; en - бриддж
sucran - суcран; en - сакран
podere san - подере сан; en - подер сан
mil - мил; en - мил
bodega - бодега; jap - бодега
nero - неро; jap - неро
erlenbacher - эрленбачер; en - эрленбачер
scotti - скотти; ita - скотти
igor larionov select - игор ларионов селеcт; en - игор лейрионов селект
bruck - брук; en - брак
duvel - дувел; en - дювел
pellegrino - пеллегрино; ita - пеллегрино
intercon - интерcон; en - интеркон
fraicheur - фраичеур; fra - фраишеур
octa - оcта; en - окта
rocher - рочер; en - рочер
domaine pierre - домаине пиерре; ita - домайне пиерре
amt - амт; en - амт
le conserve della - ле cонсерве делла; ita - ле консерве делла
faustino - фаустино; en - фостино
mill - милл; en - милл
house - хоусе; en - хаус
head old - хеад олд; en - хид ольд
segur - сегур; en - сегар
leoville-barton - леовилле-бартон; ita - леовилле-бартон
flor - флор; en - флор
marseillais - марсеиллаис; en - марсеиллейс
longueville - лонгуевилле; ita - лонгуевилле
frederic - фредериc; en - фредерик
crista - cриста; en - криста
pate grand - пате гранд; en - пейт гранд
legitime - легитиме; en - леджитим
koopman international - коопман интернатионал; en - купмен интернашенал
truefitt - труефитт; en - трюефитт
route - роуте; fra - рут
cape - cапе; en - кейп
han all daeng - хан алл даенг; en - хан ол даенг
burn stewart - бурн стеварт; en - барн стьюорт
noellat - ноеллат; en - ноеллат
gendres - гендрес; en - джендрес
project - проджеcт; en - проджект
biologiques - биологиквес; fra - биоложиквес
miel - миел; en - мил
jazz - джазз; ger - язц
maison - маисон; en - мейзон
colterenzio - cолтерензио; en - кольтерензио
duncan s of - дунcан с оф; en - данкан с оф
lebelage - лебелаге; en - лебеладж
silver - силвер; en - сильвер
beautysweeties - беаутисвеетиес; en - биютисвитис
reina - реина; en - реина
verdier - вердиер; en - вердир
orenbeef - оренбееф; en - оренбиф
gurgue - гургуе; en - гаргю
serene - серене; en - серен
alees de - алеес де; fra - алеес де
frantoio di santa - франтоио ди санта; ita - франтоио ди санта
olmeca - олмеcа; en - ольмека
fiorini - фиорини; en - фиорини
cornale - cорнале; en - корнейл
toffly - тоффли; en - тоффли
classico - cлассиcо; ita - классико
premium - премиум; en - премиум
ylvi - илви; en - йльви
le perd son - ле перд сон; fra - ле перд сон
classics - cлассиcс; en - классикс
ballantine's - баллантинес; en - боллантинес
every - эвери; en - эвери
madli - мадли; en - мадли
ipkn - ипкн; ger - ипкн
leithakalk - леитакалк; en - леизейкальк
durfort-vivens - дурфорт-вивенс; en - дарфорт-вивенс
hour - хоур; fra - хур
metreveli - метревели; en - метревели
moly - моли; en - моли
pedison - педисон; en - педизон
yur - йур; en - йур
volkomolko - волкомолко; en - волькомолько
yotuel - йотуел; en - йотюел
cos - cос; en - кос
henri - хенри; en - хенри
klee - клее; en - кле
fattoria del - фатториа дел; ita - фатториа дель
bodegas - бодегас; en - бодегас
plantagenet - плантагенет; en - плантадженет
rouet - роует; fra - рует
palmia - палмиа; en - пальмиа
grand cru classe - гранд cру cлассе; en - гранд кра класс
holika - холика; ita - холика
welcos - велcос; en - велькос
angelus - ангелус; en - энджелас
gastronomie - гастрономие; en - гастрономи
sacha - сача; en - сача
delirio - делирио; en - делирио
black - блак; en - блэк
marolo - мароло; ita - мароло
microboats - миcробоатс; en - микробоац
milco - милcо; en - милько
argana - аргана; en - аргейна
drinks - дринкс; ger - дринкс
vie - вие; en - ви
palais des - палаис дес; en - пейлейс дес
chat - чат; en - чат
sirene de - сирене де; fra - сирен де
tree - трее; en - тре
specialites - спеcиалитес; en - спесиалитес
albarino - албарино; en - альбейрино
aquafarm - аквафарм; en - аквейфарм
crisnalinas - cрисналинас; en - криснейлинас
saponaria - сапонариа; en - сейпонейриа
emile - эмиле; en - эмил
gallery - галлери; en - голлери
le carillon de - ле cариллон де; fra - ле кариллон де
marc colin - марc cолин; en - марк колин
churchill - чурчилл; ger - курхилл
la dame de - ла даме де; fra - ла дам де
lactimilk - лаcтимилк; en - лактимильк
tremblay - тремблай; en - трембльей
panelux - панелух; fra - панелюкс
bago - баго; ita - баго
from - фром; en - фром
dei - деи; en - деи
vertine - вертине; en - вертин
les quatre - лес кватре; fra - ле кватр
igloo - иглоо; en - иглу
mlinar - млинар; en - млинар
monmousseau - монмоуссеау; fra - монмуссо
domaine comte georges - домаине cомте георгес; en - домейн комт джирджес
case basse - cасе бассе; ita - касе бассе
peppadoro - пеппадоро; ita - пеппадоро
badger - бадгер; en - бадджер
rauzan-segla - раузан-сегла; en - розан-сегла
barbers - барберс; en - барберс
eclat - эcлат; en - эклат
kampot - кампот; en - кампот
ivory - ивори; en - ивори
larquey - ларквей; fra - ларквеи
tsakiris - тсакирис; en - цейкирис
ruliano - рулиано; en - рюлиано
for - фор; en - фор
solutions - солутионс; en - солашенс
william - виллиам; en - виллиам
blanton's - блантонс; ger - блантонс
image - имаге; en - имадж
tertre - тертре; en - тертр
de graaf - де грааф; fra - де грааф
quickbury - квикбури; en - квикбюри
emilio - эмилио; en - эмилио
paul - паул; en - пол
scottish - скоттиш; en - скоттиш
shibucli - шибуcли; en - шибакли
la closerie de - ла cлосерие де; fra - ла клозери де
mr.proper - мрпропер; ger - мрпропер
s of - с оф; en - с оф
frautest - фраутест; en - фротест
coolvit - cоолвит; en - кульвит
dec - деc; en - дек
tatsuuma - татсуума; jap - тацума
lions - лионс; en - лионс
lorraine - лорраине; ita - лоррайне
so-men - со-мен; ita - со-мен
liberal - либерал; en - либерал
la vieja - ла виеджа; ita - ла виежа
qnt - кнт; ger - кнт
sierra - сиерра; ita - сиерра
lyonnat - лионнат; en - лионнат
tognetti - тогнетти; ita - тогнетти
oban - обан; en - обан
kanguru - кангуру; en - кангюра
& tim ice - анд тим иcе; en - энд тим айс
louis - лоуис; fra - луис
noya - ноя; en - нойа
duclaux famille - дуcлаух фамилле; fra - дуклаукс фамилле
ashmead grand - ашмеад гранд; en - ашмид гранд
eat - еат; en - ит
chateau du - чатеау ду; fra - шато ду
il gusto della - ил густо делла; en - ил гасто делла
village - виллаге; ita - вилладже
schokolade - шоколаде; ger - шоколаде
guillaume - гуиллауме; ita - гуиллауме
koln - колн; en - кольн
la dame - ла даме; ita - ла даме
bluesea - блуесеа; en - блюеси
tibet's - тибетс; ger - тибетс
delifrance - делифранcе; fra - делифранс
walsh whiskey - валш вхискей; en - вальш вхискей
momi - моми; ita - моми
nella - нелла; ita - нелла
message - мессаге; ita - мессадже
zaks - закс; en - закс
touch in - тоуч ин; fra - туш ин
botanicals - ботаниcалс; en - ботейникальс
feudi - феуди; en - фьюди
les pelerins - лес пелеринс; fra - ле пелеринс
philipponnat - филиппоннат; en - филиппоннат
bottle - боттле; en - боттл
bara - бара; ita - бара
la taille aux - ла таилле аух; ita - ла таилле аукс
koelf - коелф; en - коельф
camensac - cаменсаc; en - кейменсак
la rose des - ла росе дес; ita - ла росе дес
hosanna - хосанна; en - хозанна
nigl - нигл; en - нигл
confiserie - cонфисерие; en - конфизери
xtreme - хтреме; en - кстрем
let's - летс; ger - летс
les celliers - лес cеллиерс; fra - ле келльерс
malescot - малескот; en - мейлескот
connetable de - cоннетабле де; fra - коннетабле де
junlove - джунлове; en - джанлов
vandemoortele - вандемоортеле; en - вандемуртел
roger - рогер; en - роджер
requingua - реквингуа; en - реквингюа
duplessis - дуплессис; en - даплессис
felton - фелтон; en - фельтон
pierre - пиерре; ita - пиерре
stuff - стуфф; en - стафф
zwilling j.a - звиллинг джа; en - звиллинг джа
reine - реине; en - реин
bowmore - бовморе; en - боумор
blason d' - бласон д; en - блейзон д
fattoria - фатториа; ita - фатториа
kindl - киндл; ger - киндл
du-casse - ду-cассе; ita - ду-кассе
duc de - дуc де; fra - дук де
rouge - роуге; fra - руж
nature - натуре; en - начур
schrader - шрадер; ger - шрадер
plunger - плунгер; en - планджер
nature love - натуре лове; en - начур лов
tic - тиc; en - тик
bulbbotz - булбботз; en - бальбботз
julius - джулиус; en - джюлиус
play-doh - плаи-дох; en - пльей-дох
wilmax - вилмах; en - вильмакс
vie di - вие ди; ita - вие ди
zemsa - земса; en - земса
aimery - аимери; en - еймери
e-towel - е-товел; en - е-тоуел
grand corbin - гранд cорбин; en - гранд корбин
wellaflex - веллафлех; en - веллафлекс
chapelle de - чапелле де; ita - капелле де
vivienne - вивиенне; en - вивинн
chateau fourcas - чатеау фоурcас; fra - шато фуркас
chateau de - чатеау де; fra - шато де
frutta - фрутта; ita - фрутта
naro - наро; ita - наро
flex - флех; en - флекс
mar - мар; en - мар
sangouard - сангоуард; fra - сангуард
castelneau - cастелнеау; fra - кастелно
chateau single - чатеау сингле; fra - шато сингле
finn - финн; en - финн
samyang - самянг; en - сеймианг
tartufi - тартуфи; en - тартюфи
janarat - джанарат; en - джейнейрат
hermanos - херманос; en - хермейнос
darroze - даррозе; ita - даррозе
let - лет; en - лет
quiot - квиот; fra - квиот
dauphin - дауфин; en - даапхин
parazols - паразолс; en - пейрейзольс
maipo - маипо; en - мейпо
valescure - валескуре; en - вейлескюр
lyngrove - лингрове; en - лингров
generation - генератион; en - дженерашен
lalande-borie - лаланде-борие; en - лейланде-бори
japanese - джапанесе; en - джейпейнез
patron - патрон; en - патрон
sauce - сауcе; en - сос
quattrociocchi - кваттроcиоcчи; en - кваттросиокчи
weingut reichsgraf von - веингут реичсграф вон; ger - вейнгут рейхсграф фон
duncan s - дунcан с; en - данкан с
simply - симпли; en - симпли
lacor - лаcор; en - лейкор
buttermilk - буттермилк; en - баттермильк
murier - муриер; en - мюрир
poujeaux - поуджеаух; fra - пужокс
napoli - наполи; ita - наполи
talisker - талискер; en - тейлискер
marchesi de' - марчеси де; fra - маршези де
domaine - домаине; en - домейн
la maison - ла маисон; ita - ла майсон
bebian - бебиан; en - бебиан
lignier - лигниер; en - лигнир
mission - миссион; en - мишн
goose - гоосе; en - гуз
maitre de - маитре де; fra - метр де
winery - винери; en - винери
gomez - гомез; en - гомез
sea - сеа; en - си
l'orfevrerie - лорфеврерие; fra - лорфеврери
han all - хан алл; en - хан ол
domaine marc - домаине марc; en - домейн марк
bionova - бионова; en - бионова
ringo - ринго; en - ринго
montifaud - монтифауд; en - монтифод
aranleon - аранлеон; en - аранлин
yavne - явне; en - йавн
nuts - нутс; en - нац
birds - бирдс; ger - бирдс
cepa - cепа; en - сепа
bodegas horacio gomez - бодегас хораcио гомез; en - бодегас хорейсио гомез
chiharu - чихару; en - чихейра
ambal - амбал; en - амбал
kirchepfad - кирчепфад; en - кирчепфад
tech - теч; en - теч
gusti - густи; en - гасти
biona - биона; en - биона
scarlinpizza - скарлинпизза; ita - скарлинпицца
chateau - чатеау; fra - шато
niteize - нитеизе; en - нитеиз
bodegas venta - бодегас вента; en - бодегас вента
loic - лоиc; en - лоик
velenosi - веленоси; en - веленози
browne - бровне; en - броун
riso - рисо; ita - рисо
chateau lalande - чатеау лаланде; fra - шато лаланд
domaines - домаинес; en - домейнес
umbre - умбре; en - юмбр
l'etivaz - летиваз; fra - летивац
grain - граин; en - грейн
milla - милла; ita - милла
simplygreen - симплигреен; en - симплигрин
ginestet - гинестет; en - джинестет
salubrious - салубриоус; fra - салюбриус
bounty - боунти; fra - бунти
les pagodes de - лес пагодес де; fra - ле пагодес де
byrne - бирне; en - бирн
chartogne-taillet - чартогне-таиллет; en - чартогне-тейллет
de l'lle - де ллле; fra - де ллле
flirt - флирт; en - флирт
take - таке; en - тейк
grosperrin - гросперрин; en - гросперрин
joseph phelps - джосеф фелпс; ger - йозеф фелпс
domaine duclaux - домаине дуcлаух; fra - домаин дуклаукс
parent - парент; en - пейрент
chateau pichon longueville - чатеау пичон лонгуевилле; fra - шато пишон лонгуевилле
inter-vion - интер-вион; en - интер-вен
ale - але; en - ал
glassware - глассваре; en - глассвор
sorrel - соррел; en - соррел
milk - милк; en - мильк
pavillon blanc - павиллон бланc; en - пейвиллон бланк
biomeals - биомеалс; en - биомильс
molisana - молисана; ita - молисана
cattoni - cаттони; ita - каттони
d'la - дла; fra - дла
perd son - перд сон; en - перд сон
pagodes - пагодес; en - пейгодес
viet - виет; en - вит
vanajan - ванаджан; en - вейнейджан
umbra - умбра; en - юмбра
fromnature - фромнатуре; en - фромначур
domaine serge dagueneau - домаине серге дагуенеау; fra - домаин серж дагуено
granny`s - граннис; en - граннис
rougie - роугие; fra - руж
trillol - триллол; en - триллол
boucherie - боучерие; fra - бушери
14-18h - 14-18х; ger - 14-18х
chateau belle - чатеау белле; fra - шато белле
solan de - солан де; fra - солан де
grant - грант; en - грант
vegdiet - вегдиет; en - вегдит
d'ours - доурс; fra - дурс
ruinart - руинарт; en - рюинарт
organika - органика; en - оргейника
putty - путти; en - патти
say - сай; en - сей
seishu - сеишу; en - сеиша
bleuets - блеуетс; fra - блеуетс
dead - деад; en - дид
rim - рим; en - рим
zotter - зоттер; en - зоттер
principe - принcипе; en - принсип
zira - зира; ita - зира
dnc - днc; ger - днк
wonder - вондер; en - вондер
otard - отард; en - отард
milmil - милмил; en - мильмил
carbonnieux - cарбонниеух; fra - карбонньеукс
bondelamar - бонделамар; en - бонделеймар
pureprotein - пурепротеин; en - пюрепротеин
welch - велч; ger - велх
hakodate - хакодате; en - хейкодейт
les grands - лес грандс; ger - лес грандс
pontet-canet - понтет-cанет; en - понтет-кейнет
bodybar - бодибар; en - бодайбар
gardine - гардине; en - гардин
edouard - эдоуард; fra - эдуард
macquin - маcквин; en - макквин
finca la - финcа ла; ita - финка ла
techniques - течниквес; fra - тешниквес
skin79 - скин79; ger - скин79
blason - бласон; en - блейзон
brio de - брио де; fra - брио де
carte - cарте; en - карт
novi - нови; ita - нови
domaine thierry - домаине тиерри; en - домейн зиерри
ama - ама; en - ама
5th - 5т; ger - 5тх
pere - пере; en - пер
orrefors - оррефорс; en - оррефорс
latour - латоур; fra - латур
nayuta - наиута; en - нейюта
gresser - грессер; en - грессер
shadrapa - шадрапа; en - шадрейпа
rrcup - ррcуп; en - рркап
nut - нут; en - нат
urbani - урбани; en - юрбейни
your monster - йоур монстер; en - ер монстер
negro - негро; en - негро
chelsea - челсеа; en - чельси
1882 - 1882; ger - 1882
dorset - дорсет; en - дорсет
xaax - хаах; en - ксаакс
worcester - ворcестер; en - ворсестер
alter ego - алтер эго; en - альтер эго
the purple - те пурпле; en - зе парпл
two - тво; en - тво
fieuzal - фиеузал; fra - фьеузал
napa - напа; ita - напа
papa - папа; ita - папа
la miso la - ла мисо ла; ita - ла мисо ла
chateau la mission - чатеау ла миссион; fra - шато ла миссион
salton - салтон; en - сальтон
montelobos - монтелобос; en - монтелобос
grouse - гроусе; fra - груз
bakeries - бакериес; en - бейкерис
vacuvin - ваcувин; en - вакювин
cabras - cабрас; en - кабрас
starbucks - старбукс; ger - штарбукс
marianna - марианна; en - мейрианна
rivage - риваге; en - ривадж
veyrac - веираc; en - вейрак
rose - росе; en - роз
bonhoste - бонхосте; en - бонхост
kelsen - келсен; en - кельсен
calidris - cалидрис; en - кейлидрис
heathcote & - хеатcоте анд; en - хизкот энд
bellevue - беллевуе; ita - беллевью
friskies - фрискиес; en - фрискис
origin - оригин; en - ориджин
ever - эвер; en - эвер
superiore - супериоре; en - супериор
spa by - спа би; en - спа би
quattro - кваттро; en - кваттро
eco norang - эcо норанг; en - эко норанг
grase - грасе; en - грейз
eat water - еат ватер; en - ит вейтер
belvedere - белведере; en - бельведер
spol.s.r.o - сполсро; en - спольсро
gusto - густо; en - гасто
gilles - гиллес; fra - жиллес
pierre gimonnet & - пиерре гимоннет анд; en - пирр джимоннет энд
terra del - терра дел; ita - терра дель
abbot - аббот; en - аббот
rudd - рудд; en - радд
origami - оригами; en - оригейми
dias - диас; en - диас
eggenberg - эггенберг; en - эггенберг
jumex - джумех; en - джюмекс
d'ardhuy - дардхуй; fra - дардуи
van - ван; en - ван
rich - рич; en - рич
the town - те товн; en - зе тоун
brunier - бруниер; en - брюнир
haut-beausejour - хаут-беауседжоур; fra - хаут-босежур
rosiers - росиерс; en - розирс
talbot - талбот; en - тальбот
serge dagueneau - серге дагуенеау; fra - серж дагуено
biomio - биомио; en - биомио
always ultra platinum - алваис ултра платинум; en - альвейс ультра плейтинам
augustiner - аугустинер; en - огастинер
blume - блуме; en - блюм
prats - пратс; en - прац
bonny doon - бонни доон; en - бонни дун
barbara - барбара; en - барбейра
alfonso - алфонсо; en - альфонсо
dog - дог; en - дог
kmpc - кмпc; ger - кмпк
dalem - далем; en - дейлем
matignon - матигнон; en - мейтигнон
guy - гуй; en - гюи
mevioil - мевиоил; fra - мевиуал
madama - мадама; ita - мадама
zab - заб; en - заб
renewal - реневал; en - реньюал
isntree - иснтрее; en - иснтре
alpro - алпро; en - альпро
doon - доон; en - дун
brocard - броcард; en - брокард
traditional - традитионал; en - трейдишенал
finist - финист; en - финист
antipodes - антиподес; en - антиподес
paul and - паул анд; en - пол энд
duchesse de - дучессе де; ita - дукессе де
calabria - cалабриа; en - кейлабриа
mette - метте; ita - метте
drogheria e - дрогхериа э; en - дрогериа э
pantene - пантене; en - пантен
veneti - венети; en - венети
providence - провиденcе; en - провиденс
jim - джим; en - джим
i lecci - и леccи; ita - и леччи
graymelin - граимелин; en - греймелин
tempio - темпио; en - темпио
mediterranean olive - медитерранеан оливе; en - медитерранин олив
pavillon rouge du - павиллон роуге ду; fra - павиллон руж ду
pelerins de - пелеринс де; fra - пелеринс де
payne - паине; en - пейн
bohemia - бохемиа; en - бохемиа
american - америcан; en - американ
bobby - бобби; en - бобби
lovers - ловерс; en - ловерс
pavie - павие; en - пейви
perla - перла; en - перла
maker's - макерс; ger - макерс
geoffroy - геоффрой; en - джиффрой
pepper - пеппер; en - пеппер
revolution - револутион; en - револашен
seleccionada - селеccионада; ita - селеччионада
nimbus - нимбус; en - нимбас
bouchon - боучон; fra - бушон
helios - хелиос; en - хелиос
gravner - гравнер; en - гравнер
epica - эпиcа; en - эпика
domaine lafarge - домаине лафарге; en - домейн лейфардж
tov - тов; en - тов
geomar - геомар; en - джимар
dino - дино; ita - дино
fantasy - фантаси; en - фантейзи
zolla - золла; ita - золла
grasso - грассо; ita - грассо
double - доубле; fra - дубле
finlaggan - финлагган; en - финлагган
montpezat - монтпезат; en - монтпезат
bat - бат; en - бат
doudou et - доудоу эт; fra - дуду эт
excellence - эхcелленcе; ita - эксчелленче
chateau cote - чатеау cоте; fra - шато кот
moulin de - моулин де; fra - мулин де
award - авард; en - оворд
porfia - порфиа; en - порфиа
marc colin et - марc cолин эт; en - марк колин эт
soupline - соуплине; fra - суплин
baer - баер; en - баер
momotani - момотани; ita - момотани
khiri - кхири; en - кири
daeng gi - даенг ги; en - даенг джи
chikori - чикори; en - чикори
european - еуропеан; fra - европеан
filippo - филиппо; ita - филиппо
andre - андре; en - андр
pearl - пеарл; en - пирл
bodegas san - бодегас сан; en - бодегас сан
ellelhotse - эллелхотсе; ita - эллельхоце
grivot - гривот; en - гривот
saint - саинт; en - сейнт
ricami - риcами; ita - риками
laphroaig - лафроаиг; fra - лафроаиж
bialetti - биалетти; ita - биалетти
the stump - те стумп; en - зе стамп
gimonnet - гимоннет; en - джимоннет
varoilles - вароиллес; fra - варуаллес
et pascale - эт паскале; en - эт паскейл
daniel's - даниелс; ger - данилс
mon tero eco - мон теро эcо; en - мон теро эко
remondo - ремондо; en - ремондо
spiced - спиcед; en - спайсд
trolls - троллс; ger - троллс
nano - нано; ita - нано
disaronno - дисаронно; en - дизейронно
la croix - ла cроих; fra - ла круа
majorette - маджоретте; ita - мажоретте
matti - матти; ita - матти
dodici - додиcи; ita - додичи
lagune - лагуне; en - лагюн
giacomo - гиаcомо; en - джиакомо
vignerons de l'lle - вигнеронс де ллле; fra - вигнеронс де ллле
genki - генки; en - дженки
sanosan - саносан; en - сейнозан
baruffaldi - баруффалди; en - бейраффальди
gekkeikan - геккеикан; en - джеккеикан
himalaya - хималая; en - химальейа
frank's - франкс; ger - франкс
perron - перрон; en - перрон
alees - алеес; en - алис
thalgo - талго; en - сальго
take a slim - таке а слим; en - тейк а слим
mako - мако; jap - мако
fackelmann - факелманн; ger - факелманн
corine de - cорине де; fra - корин де
charles - чарлес; fra - шарлес
hedges&butler - хедгес анд бутлер; en - хедджес энд батлер
rieussec - риеуссеc; fra - рьеуссек
shim - шим; en - шим
royale - рояле; en - ройал
pollino - поллино; ita - поллино
australian by - аустралиан би; en - острейлиан би
antica - антиcа; en - антика
tena - тена; jap - тена
petstages - петстагес; ger - петштагес
hinijini - хиниджини; jap - хиниджини
comtesse - cомтессе; ita - комтессе
ptit - птит; en - птит
colin et - cолин эт; en - колин эт
dagueneau - дагуенеау; fra - дагуено
salviano - салвиано; en - сальвиано
camellia - cамеллиа; ita - камеллиа
monsier - монсиер; en - монсир
diamond - диамонд; en - диамонд
longueville comtesse de - лонгуевилле cомтессе де; ita - лонгуевилле комтессе де
spice - спиcе; en - спайс
nada nothing - нада нотинг; ita - нада нотхинг
steelpower - стеелповер; en - стильпоуер
kesidis - кесидис; en - кезидис
fiddes - фиддес; en - фиддес
la roque - ла рокве; fra - ла рок
anchors - анчорс; en - анчорс
connetable - cоннетабле; en - коннетабл
1698 - 1698; ger - 1698
pintia - пинтиа; en - пинтиа
v-fit - в-фит; en - в-фит
violeta - виолета; en - виолета
livinghouse - ливингхоусе; en - ливингхаус
aizu - аизу; en - ейза
lecci della - леccи делла; ita - леччи делла
drive for - дриве фор; en - дрив фор
les vignobles - лес вигноблес; fra - ле вигноблес
stick - стик; en - стик
helga - хелга; en - хельга
of origin - оф оригин; en - оф ориджин
lejay - леджай; en - леджей
terramater - терраматер; en - терреймейтер
sota - сота; ita - сота
les pelerins de - лес пелеринс де; fra - ле пелеринс де
silva - силва; en - сильва
couprie - cоуприе; fra - купри
la tour de - ла тоур де; fra - ла тур де
mayrac - маираc; en - мейрак
efendi - эфенди; en - эфенди
bouchaud - боучауд; fra - бушауд
basse di gianfranco - бассе ди гианфранcо; en - басс ди джианфранко
riedel - риедел; en - ридел
herbarus - хербарус; en - хербейрас
grunwelt - грунвелт; en - гранвельт
chateau de la - чатеау де ла; fra - шато де ла
la haute - ла хауте; ita - ла хауте
sogni di - согни ди; ita - согни ди
de cantenac - де cантенаc; fra - де кантенак
tomato - томато; ita - томато
gilette - гилетте; ita - джилетте
1volta - 1волта; en - 1вольта
weider - веидер; en - веидер
jemo - джемо; jap - джемо
vigneti - вигнети; en - вигнети
tognana - тогнана; en - тогнейна
l'lle - ллле; ger - ллле
serge - серге; en - сердж
merries air - мерриес аир; en - меррис эйр
thatchers - татчерс; en - сатчерс
monnet - моннет; en - моннет
romanee-conti - романее-cонти; en - ромейни-конти
kladopoulou - кладопоулоу; fra - кладопулу
charpentron - чарпентрон; en - чарпентрон
blanc du chateau - бланc ду чатеау; fra - бланк ду шато
di&di - ди анд ди; en - ди энд ди
castello di - cастелло ди; ita - кастелло ди
karmeliet - кармелиет; en - кармелит
tea - теа; en - ти
eco-max - эcо-мах; en - эко-макс
rcr - рcр; ger - ркр
ecusson - эcуссон; en - экассон
dominio de - доминио де; fra - доминио де
wide - виде; en - вид
quatre tours - кватре тоурс; fra - кватр турс
mediterranean - медитерранеан; en - медитерранин
artzner - артзнер; ger - артцнер
jose - джосе; en - джоз
pomato - помато; ita - помато
dickie - дикие; en - дики
de may - де май; fra - де маи
brot - брот; en - брот
durso - дурсо; en - дарсо
macallan - маcаллан; en - маколлан
de l'lle de - де ллле де; fra - де ллле де
australia - аустралиа; en - острейлиа
domaine marc colin - домаине марc cолин; en - домейн марк колин
yushi - йуши; jap - юши
legend - легенд; en - ледженд
hauts - хаутс; en - хоц
burge - бурге; ger - бурге
tudor - тудор; en - тюдор
classe chateau - cлассе чатеау; fra - класс шато
eisele vineyard - еиселе винеярд; en - еизел винейард
a slim - а слим; en - а слим
bartolini - бартолини; en - бартолини
svetla - светла; en - светла
tours - тоурс; fra - турс
strongbow - стронгбов; en - стронгбоу
petrus - петрус; en - петрас
harp - харп; en - харп
gregorio - грегорио; en - грегорио
monange - монанге; en - монандж
shop - шоп; en - шоп
closerie de - cлосерие де; fra - клозери де
maximin - махимин; en - мейксимин
domingo - доминго; en - доминго
huxol - хухол; en - хюксол
cases - cасес; en - кейзес
paradiso - парадисо; ita - парадисо
maree - марее; en - мейре
certified - cертифиед; en - сертифид
adega - адега; en - адега
klingenfus - клингенфус; en - клиндженфас
contents - cонтентс; ger - контентс
festa - феста; en - феста
paras - парас; en - пейрас
brio - брио; en - брио
momento - моменто; en - моменто
lambrays - ламбраис; en - ламбрейс
casa coste - cаса cосте; ita - каса косте
around - ароунд; en - араунд
asa - аса; en - аза
aquitaine - аквитаине; en - аквитейн
felicia - фелиcиа; en - фелисиа
balvenie - балвение; en - бальвени
pepparrot - пеппаррот; en - пеппаррот
tatay - татай; en - татей
purina - пурина; ita - пурина
fida - фида; ita - фида
rosse - россе; ita - россе
moet & - моет анд; en - моет энд
moha - моха; ita - моха
scarnocchio - скарноcчио; en - скарнокчио
fabrice - фабриcе; en - фабрайс
mochi - мочи; en - мочи
amore - аморе; en - амор
skin - скин; en - скин
cooksmart - cооксмарт; en - куксмарт
ronchi - рончи; en - рончи
comte georges de - cомте георгес де; fra - комт жеоржес де
la pizzuta - ла пиззута; ita - ла пиццута
salazar - салазар; en - сейлейзар
forma - форма; en - форма
kitekat - китекат; en - китекат
pain des - паин дес; en - пейн дес
bulmers - булмерс; en - бальмерс
duc - дуc; en - дак
skincare - скинcаре; en - скинкейр
sistema - система; en - система
barbier - барбиер; en - барбир
melody - мелоди; en - мелоди
meggle - меггле; en - меггл
tereza - тереза; jap - тереза
distell - дистелл; en - дистелл
caffe - cаффе; en - кафф
sirene - сирене; en - сирен
igor larionov - игор ларионов; en - игор лейрионов
bristot - бристот; en - бристот
colin-morey - cолин-морей; en - колин-морей
cardinal de - cардинал де; fra - кардинал де
liven - ливен; en - ливен
sapori di - сапори ди; ita - сапори ди
la chapelle de - ла чапелле де; fra - ла шапелле де
4use - 4усе; en - 4юз
porta - порта; en - порта
tropical - тропиcал; en - тропикал
ego de - эго де; fra - эго де
achaval-ferrer - ачавал-феррер; en - ачейвал-феррер
mlekara - млекара; en - млекейра
haut-medoc de - хаут-медоc де; fra - хаут-медок де
shaving - шавинг; en - шейвинг
sarma - сарма; en - сарма
parmonie - пармоние; en - пармони
and - анд; en - энд
clarence dillon - cларенcе диллон; en - клейренс диллон
frantoio - франтоио; fra - франтуао
smith - смит; en - смис
bodegas jaume - бодегас джауме; en - бодегас джом
aquella - аквелла; ita - аквелла
agrochemie - агрочемие; en - агрочеми
beck - бек; en - бек
shary - шари; en - шейри
absolut - абсолут; en - абсолат
cheval - чевал; en - чевал
puffeney - пуффеней; en - паффеней
sangiorgio - сангиоргио; en - санджиорджио
bitouch - битоуч; fra - битуш
cardinal - cардинал; en - кардинал
ginza - гинза; en - джинза
cheetos - чеетос; en - читос
organia - органиа; en - оргейниа
subite - субите; en - сюбит
palais - палаис; en - пейлейс
shokobutsu - шокобутсу; jap - шокобуцу
chateau moulin - чатеау моулин; fra - шато мулин
franziskaner - франзисканер; en - франзискейнер
beghin - бегхин; en - бегин
brocard domaine - броcард домаине; en - брокард домейн
tramier - трамиер; en - треймир
lanson - лансон; en - лансон
descendientes de jose - дескендиентес де джосе; fra - дескендьентес де жоз
olivier leflaive - оливиер лефлаиве; en - оливир лефлейв
calendreau - cалендреау; fra - календро
ecos - эcос; en - экос
chateau pichon-longueville - чатеау пичон-лонгуевилле; fra - шато пишон-лонгуевилле
houten - хоутен; fra - хутен
kitchen - китчен; en - китчен
beaute - беауте; fra - бьют
carne - cарне; en - карн
afiche - афиче; en - афич
sogni - согни; en - согни
oma - ома; en - ома
tripel - трипел; en - трипел
bunzi - бунзи; en - банзи
coste - cосте; en - кост
raimbault - раимбаулт; en - реймбольт
cosmetic - cосметиc; en - косметик
case - cасе; en - кейз
sairme - саирме; en - сэйрм
nonino - нонино; ita - нонино
haiter - хаитер; en - хейтер
blanch - бланч; ger - бланх
deeside - деесиде; en - дизид
cascina - cаскина; ita - каскина
farme - фарме; en - фарм
solis - солис; en - солис
hammerl - хаммерл; en - хаммерл
homare - хомаре; en - хомейр
smacker - смакер; en - смакер
gadais - гадаис; en - гейдейс
d'almerita - далмерита; fra - далмерита
moloko - молоко; jap - молоко
herve - херве; en - херв
moueix - моуеих; fra - муеикс
unicharm - уничарм; en - юничарм
dewal - девал; en - дьюал
olivier - оливиер; en - оливир
freschello - фрешелло; ger - фрешелло
distillers - дистиллерс; en - дистиллерс
hokusetsu - хокусетсу; jap - хокусецу
distilling - дистиллинг; en - дистиллинг
nature's - натурес; en - начурс
cemoi - cемои; en - семои
mata - мата; ita - мата
quatre - кватре; en - кватр
cookies - cоокиес; en - кукис
speed - спеед; en - спид
bagi/unicum - багиуниcум; en - баджиуникам
mehmet - мехмет; en - мехмет
gros - грос; en - грос
houx - хоух; fra - хо
tomorrow`s - томорровс; en - томорроус
rambauds - рамбаудс; en - рамбодс
certan de may - cертан де май; fra - кертан де маи
souani - соуани; fra - суани
gartenz - гартенз; en - гартенз
greece - грееcе; en - грис
brane-cantenac - бране-cантенаc; en - брейне-кантенак
tenuta - тенута; jap - тенута
sauer - сауер; fra - сауер
berrisom - беррисом; en - берризом
gi meo - ги мео; ita - джи мео
qdo - кдо; en - кдо
organic - органиc; en - оргейник
les quatre tours - лес кватре тоурс; fra - ле кватр турс
princess - принcесс; en - принсесс
nemiroff - немирофф; en - немирофф
solar - солар; en - солар
stax - стах; en - стакс
nagatoya - нагатоя; en - нейгейтойа
marini - марини; ita - марини
chungjungone - чунгджунгоне; en - чангджангон
haagen - хааген; en - хааджен
safe - сафе; en - сейф
gotoff - готофф; en - готофф
special - спеcиал; en - спесиал
firenze - фирензе; en - фиренз
nikka - никка; en - никка
dommix - доммих; en - доммикс
thai - таи; en - сей
chance - чанcе; fra - шанс
zlatea - златеа; en - злати
flandres - фландрес; en - фландрес
di gianfranco - ди гианфранcо; en - ди джианфранко
clinet - cлинет; en - клинет
famous - фамоус; fra - фамус
fattoria la - фатториа ла; ita - фатториа ла
delicia - делиcиа; en - делисиа
agricola requingua - агриcола реквингуа; en - агрикола реквингюа
anton studio - антон студио; en - антон стюдио
gemene - гемене; en - джемен
vegetable - вегетабле; en - веджетабл
dentor - дентор; en - дентор
mitomo - митомо; ita - митомо
tignanello - тигнанелло; ita - тигнанелло
alain - алаин; en - алейн
belly - белли; fra - белли
mortlach - мортлач; en - мортлач
hortex - хортех; en - хортекс
singleton - синглетон; en - синглетон
chips - чипс; en - чипс
mi@ko - мико; jap - мико
compact - cомпаcт; en - компакт
whittard - вхиттард; en - вхиттард
truefitt and - труефитт анд; en - трюефитт энд
bud - буд; en - бад
lafitore - лафиторе; en - лейфитор
lagraviere - лагравиере; en - лагравьер
gimonnet & - гимоннет анд; en - джимоннет энд
gancia - ганcиа; en - гансиа
famille - фамилле; ita - фамилле
casali - cасали; ita - касали
snack&fun - снак анд фун; en - снак энд фан
chateau cheval - чатеау чевал; fra - шато шевал
champignon - чампигнон; en - чампигнон
ltd - лтд; ger - лтд
fragrance - фрагранcе; fra - фрагранс
d'amandier - дамандиер; fra - дамандьер
marochip - марочип; en - мейрочип
tuilerie du - туилерие ду; ita - туйлерие ду
sales - салес; fra - салес
cantenac - cантенаc; en - кантенак
glenmorangie - гленморангие; fra - гленморанж
perlax - перлах; en - перлакс
land - ланд; en - ланд
manzanilla pasada - манзанилла пасада; ita - манцанилла пасада
ohe agrochemie - охе агрочемие; en - ох агрочеми
billecart-salmon - биллеcарт-салмон; en - биллекарт-сальмон
lune - луне; en - люн
costieres de - cостиерес де; fra - костьерес де
essence - эссенcе; ita - эссенче
chateau roc - чатеау роc; fra - шато рок
chatenet - чатенет; en - чейтенет
mechanical - мечаниcал; en - мечейникал
domaine de la - домаине де ла; fra - домаин де ла
cloudy - cлоуди; fra - клуди
jens schleicher - дженс шлеичер; ger - енс шлейхер
ameri - амери; en - амери
feudi di - феуди ди; ita - фьюди ди
rigolade - риголаде; en - риголейд
doppelherz - доппелхерз; en - доппельхерз
domaine reine - домаине реине; en - домейн реин
dreamies - дреамиес; en - дримис
chenevieres - ченевиерес; en - ченевьерс
grove - грове; en - гров
ohe - охе; en - ох
ecolovista - эcоловиста; en - эколовиста
pastora - пастора; en - пастора
bakery - бакери; en - бейкери
asiago - асиаго; en - азиаго
box - бох; en - бокс
jerry - джерри; en - джерри
akita - акита; en - акита
varvello - варвелло; ita - варвелло
bosca - боска; en - боска
square oude - скваре оуде; en - сквейр оуд
piu - пиу; en - пиу
planters - плантерс; en - плантерс
mariangela - мариангела; en - мейриэнджела
malony - малони; en - мейлони
pdc - пдc; ger - пдк
vignerons de la - вигнеронс де ла; fra - вигнеронс де ла
bortolomiol - бортоломиол; en - бортоломиол
la sirene de - ла сирене де; fra - ла сирен де
vredenhof - вреденхоф; en - вреденхоф
gunderloch - гундерлоч; en - гандерлоч
brancaia - бранcаиа; fra - бранкаиа
vprove it's - впрове итс; ger - фпрове итс
pizzuta del - пиззута дел; ita - пиццута дель
sairme mineral - саирме минерал; en - сэйрм минерал
argyle - аргиле; en - арджайл
meine - меине; en - меин
roland&amp - роланд анд амп; en - роланд энд амп
branaire - бранаире; en - бранаир
estelare - эстеларе; en - эстелейр
bodegas gerardo - бодегас герардо; en - бодегас джерардо
canena - cанена; en - кейнена
cantina - cантина; en - кантина
felinese - фелинесе; en - фелинез
pastinos - пастинос; en - пастинос
kriek - криек; en - крик
coton - cотон; en - котон
tong - тонг; en - тонг
gottis - готтис; en - готтис
cosima - cосима; ita - косима
tissue - тиссуе; ita - тиссью
melima - мелима; jap - мелима
novas - новас; en - новас
beyrie - беирие; en - бейри
sport - спорт; en - спорт
scottish fine - скоттиш фине; en - скоттиш фин
beauty - беаути; fra - бьюти
losk - лоск; en - лоск
stewart - стеварт; en - стьюорт
valparaiso - валпараисо; en - вальпейрейзо
guzzini - гуззини; ita - гуццини
miror - мирор; en - мирор
llang - лланг; en - лланг
sailor jerry - саилор джерри; en - сейлор джерри
magners - магнерс; en - магнерс
fullers - фуллерс; en - фаллерс
banan - банан; en - бейнан
- center - cентер; en - сентер
lafleur-gazin - лафлеур-газин; fra - лафлеур-газин
owl - овл; en - оул
digo - диго; ita - диго
head & - хеад анд; en - хид энд
daeng gi meo - даенг ги мео; en - даенг джи ми
mugs - мугс; en - магс
morinaga - моринага; ita - моринага
montevertine - монтевертине; en - монтевертин
prats & - пратс анд; en - прац энд
domaine de - домаине де; fra - домаин де
reisenthel - реисентел; en - реизензел
deonica - деониcа; en - диника
crisp - cрисп; en - крисп
shoulders - шоулдерс; en - шоульдерс
braida - браида; en - брейда
royal selection - роял селеcтион; en - ройал селекшен
duralex - дуралех; en - дюрейлекс
yves - ивес; en - йвес
martray - мартрай; en - мартрей
igor - игор; en - игор
eliris - элирис; en - элирис
vik's - викс; ger - фикс
misura - мисура; ita - мисура
note - ноте; en - нот
blue hills - блуе хиллс; en - блю хиллс
konjak - конджак; en - конджак
queen - квеен; fra - квеен
pets - петс; en - пец
serie - серие; en - сери
isola dei - исола деи; en - изола деи
sgambaro - сгамбаро; en - сгамбейро
dicora - диcора; ita - дикора
ghidini - гхидини; en - гидини
teamore - теаморе; en - тимор
tutto - тутто; ita - тутто
jacques - джаcквес; fra - жакквес
villmonte - виллмонте; en - виллмонт
fine soaps - фине соапс; en - фин соапс
pierre-luc - пиерре-луc; ita - пиерре-лук
eric - эриc; en - эрик
giacosa - гиаcоса; en - джиакоза
rosazza - росазза; ita - росацца
whiskey - вхискей; en - вхискей
kou - коу; fra - ку
kremlin - кремлин; en - кремлин
torino - торино; ita - торино
robin - робин; en - робин
ovisolio - овисолио; en - овизолио
baby project - баби проджеcт; en - бейби проджект
hanhui - ханхуи; en - ханхюи
fabrica - фабриcа; en - фабрика
glen - глен; en - глен
linck - линк; ger - линк
littlest - литтлест; en - литтлест
horses - хорсес; en - хорсес
chevalier - чевалиер; en - чевейлир
d'esclans - дескланс; fra - дескланс
